Today is the day! You just know it! You are going to escape the bed!

Escaping A Container
An Interactive Fiction by Alix Leonhart
Release 1 / Serial number 250914 / Inform 7 v10.1.2 / D

Bedroom (in bed)
It's my person's old bedroom

You can see basket (empty) here.

In bed you can see decorative pillow (on which are stuffed animal and pillow mint).

>ask stuffed animal
(for basket)
(stuffed animal first taking basket)
Stuffed animal has better things to do.

>l
Bedroom (in bed)
It's my person's old bedroom

You can see basket (empty) here.

In bed you can see decorative pillow (on which are stuffed animal and pillow mint).

* * *

Today is the day! You just know it! You are going to escape the bed!

Escaping A Container
An Interactive Fiction by Alix Leonhart
Release 1 / Serial number 250914 / Inform 7 v10.1.2 / D

Bedroom (in bed)
It's my person's old bedroom

You can see basket (empty) here.

In bed you can see decorative pillow (on which are stuffed animal and pillow mint).

>enter elevator
You enter the rickety elevator and as soon as you turn to face the old lift handle, the elevator lurches down a few feet and the door grill slams shut!

You get into elevator.

In elevator you can see lever handle and Bag of bricks.

>exit
(elevator)
You triumphantly leave the old elevator!

>enter elevator
You enter the rickety elevator and as soon as you turn to face the old lift handle, the elevator lurches down a few feet and the door grill slams shut!

You get into elevator.

In elevator you can see lever handle and Bag of bricks.

>exit elevator
You triumphantly leave the old elevator!

* * *

>exit
(elevator)
You triumphantly leave the old elevator!

>l
Hotel Lobby
An old timey hotel with only one thing of interest -
...a wonky sissor hinge ancient elevator.

* * *

>exit
(elevator)
You triumphantly leave the old elevator!

>showme
Hotel Lobby - room
    elevator - open container
        yourself - person
        lever handle - device
        Bag of bricks

>status
That's not a verb I recognise.

>relation
That's not a verb I recognise.

* * *

>rules
Rules tracing now switched on. Type "rules off" to switch it off again, or "rules all" to include even rules which do not apply.

[Rule "parse command rule" applies.]

>enter elevator
[Rule "declare everything initially unmentioned rule" applies.]
[Rule "generate action rule" applies.]
[Rule "announce items from multiple object lists rule" applies.]
[Rule "set pronouns from items from multiple object lists rule" applies.]
[Rule "before stage rule" applies.]
[Rule "basic visibility rule" applies.]
[Rule "basic accessibility rule" applies.]
[Rule "access through barriers rule" applies.]
[Rule "carrying requirements rule" applies.]
[Rule "instead stage rule" applies.]
[Rule "requested actions require persuasion rule" applies.]
[Rule "carry out requested actions rule" applies.]
[Rule "descend to specific action-processing rule" applies.]
[Rule "work out details of specific action rule" applies.]
[Rule "investigate player's awareness before action rule" applies.]
[Rule "player aware of his own actions rule" applies.]
[Rule "check stage rule" applies.]
[Rule "convert enter door into go rule" applies.]
[Rule "convert enter compass direction into go rule" applies.]
[Rule "can't enter what's already entered rule" applies.]
[Rule "can't enter what's not enterable rule" applies.]
[Rule "can't enter closed containers rule" applies.]
[Rule "can't enter if this exceeds carrying capacity rule" applies.]
[Rule "can't enter something carried rule" applies.]
[Rule "implicitly pass through other barriers rule" applies.]
[Rule "carry out stage rule" applies.]
[Rule "standard entering rule" applies.]
[Rule "after stage rule" applies.]
[Rule "investigate player's awareness after action rule" applies.]
[Rule "report stage rule" applies.]
[Rule "report player entering elevator" applies.]
You enter the rickety elevator and as soon as you turn to face the old lift handle, the elevator lurchs down a few feet and the door grill slams shut!
[Rule "last specific action-processing rule" applies.]

[Rule "A first turn sequence rule" applies.]
[Rule "scene change machinery rule" applies.]
[Rule "every turn stage rule" applies.]
[Rule "Every turn" applies.]
Oh no you got to get out of here!
Maybe there is a way to reduce the weight
[Rule "timed events rule" applies.]
[Rule "advance time rule" applies.]
[Rule "update chronological records rule" applies.]
[Rule "A last turn sequence rule" applies.]
[Rule "scene change machinery rule" applies.]
[Rule "adjust light rule" applies.]
[Rule "note object acquisitions rule" applies.]
[Rule "notify score changes rule" applies.]
[Rule "parse command rule" applies.]

I beg your pardon?

>x
(elevator)
[Rule "declare everything initially unmentioned rule" applies.]
[Rule "generate action rule" applies.]
[Rule "announce items from multiple object lists rule" applies.]
[Rule "set pronouns from items from multiple object lists rule" applies.]
[Rule "before stage rule" applies.]
[Rule "basic visibility rule" applies.]
[Rule "can't act in the dark rule" applies.]
[Rule "basic accessibility rule" applies.]
[Rule "carrying requirements rule" applies.]
[Rule "instead stage rule" applies.]
[Rule "requested actions require persuasion rule" applies.]
[Rule "carry out requested actions rule" applies.]
[Rule "descend to specific action-processing rule" applies.]
[Rule "work out details of specific action rule" applies.]
[Rule "investigate player's awareness before action rule" applies.]
[Rule "player aware of his own actions rule" applies.]
[Rule "check stage rule" applies.]
[Rule "carry out stage rule" applies.]
[Rule "standard examining rule" applies.]
An old rusty elevator.

[Rule "examine directions rule" applies.]
[Rule "examine containers rule" applies.]
In elevator are lever handle and Bag of bricks.

[Rule "examine supporters rule" applies.]
[Rule "examine devices rule" applies.]
[Rule "examine undescribed things rule" applies.]
[Rule "after stage rule" applies.]
[Rule "investigate player's awareness after action rule" applies.]
[Rule "report stage rule" applies.]
[Rule "report other people examining rule" applies.]
[Rule "last specific action-processing rule" applies.]
[Rule "A first turn sequence rule" applies.]
[Rule "scene change machinery rule" applies.]
[Rule "every turn stage rule" applies.]
[Rule "Every turn" applies.]
Oh no you got to get out of here!
Maybe there is a way to reduce the weight
[Rule "timed events rule" applies.]
[Rule "advance time rule" applies.]
[Rule "update chronological records rule" applies.]
[Rule "A last turn sequence rule" applies.]
[Rule "scene change machinery rule" applies.]
[Rule "adjust light rule" applies.]
[Rule "note object acquisitions rule" applies.]
[Rule "notify score changes rule" applies.]
[Rule "parse command rule" applies.]

>showme
[Rule "declare everything initially unmentioned rule" applies.]
[Rule "generate action rule" applies.]
Hotel Lobby - room
    elevator - open container
        yourself - person
        lever handle - device
        Bag of bricks

[Rule "parse command rule" applies.]

* * *

I beg your pardon?

>rules
[Rule "declare everything initially unmentioned rule" applies.]
[Rule "generate action rule" applies.]
Rules tracing now switched on. Type "rules off" to switch it off again, or "rules all" to include even rules which do not apply.

[Rule "parse command rule" applies.]

>rules off
[Rule "declare everything initially unmentioned rule" applies.]
[Rule "generate action rule" applies.]
Rules tracing now switched off. Type "rules" to switch it on again.

I beg your pardon?

>actions
Actions listing on.

>enter elevator
[entering elevator]
You enter the rickety elevator and as soon as you turn to face the old lift handle, the elevator lurchs down a few feet and the door grill slams shut!
[entering elevator - succeeded]

Oh no you got to get out of here!
Maybe there is a way to reduce the weight

>exit
[exiting]
You get out of elevator.

Hotel Lobby
An old timey hotel with only one thing of interest -
...a wonky sissor hinge ancient paternoster elevator.

[exiting - succeeded]

* * *

>enter elevator
You enter the rickety elevator and as soon as you turn to face the old lift handle, the elevator lurches down a few feet and the door grill slams shut!

You get into elevator.

In elevator you can see lever handle and Bag of bricks.

>exit elvator
I only understood you as far as wanting to exit.

>exit elevator
I only understood you as far as wanting to exit.

>exit
Oh no you got to get out of here!
Maybe there is a way to reduce the weight

* * *

>enter elevator
You enter the rickety elevator and as soon as you turn to face the old lift handle, the elevator lurches down a few feet and the door grill slams shut!

You get into elevator.

In elevator you can see lever handle and Bag of bricks.

>get in elevator
You can't go that way.

* * *

>enter elevator
You enter the rickety elevator and as soon as you turn to face the old lift handle, the elevator lurches down a few feet and the door grill slams shut!

You get into elevator.

In elevator you can see lever handle and Bag of bricks.

>get out of elevator
Oh no you got to get out of here!
Maybe there is a way to reduce the weight

* * *

>enter elevator
You enter the rickety elevator and as soon as you turn to face the old lift handle, the elevator lurches down a few feet and the door grill slams shut!

You get into elevator.

In elevator you can see lever handle and Bag of bricks.

>leave
That's not a verb I recognise.

>exit
(elevator)
You can't the elevator door is stuck tight, maybe if the elevator can be raised up to it's normal resting location.

>pull lever
the elevator grinds it seems too heavy to move up a few feet back into place.

>throw bricks
(first taking Bag of bricks)
Brick by brick you throw them through the elevator gate from the bag until there are none left and notice more of a spring to your steps in the elevator.

Oh no you got to get out of here!

>take bag of bricks
You can't reach Bag of bricks from here.

Oh no you got to get out of here!

>throw
(Bag of bricks)
(first taking Bag of bricks)
You can't reach Bag of bricks from here.

Oh no you got to get out of here!

>take all
Bag of bricks: You can't reach Bag of bricks from here.

Oh no you got to get out of here!

>throw bag of bricks
(first taking Bag of bricks)
You can't reach Bag of bricks from here.

Oh no you got to get out of here!

>pull lever
Grabbing the lift handle you bring the elevator back up completely aligned to the egress and the rusty grate swings open!

Oh no you got to get out of here!

>exit
(elevator)
You triumphantly leave the old elevator!

Hotel Lobby
An old timey hotel with only one thing of interest -
...a wonky sissor hinge ancient paternoster elevator.

You can see Bag of bricks here.

Oh no you got to get out of here!

    *** Whew! You escaped the elevator! ***

Would you like to RESTART, RESTORE a saved game, QUIT or UNDO the last command?

>hop
Please give one of the answers above.

Would you like to RESTART, RESTORE a saved game, QUIT or UNDO the last command?

>showme
Please give one of the answers above.

Would you like to RESTART, RESTORE a saved game, QUIT or UNDO the last command?

>exit elevator
Please give one of the answers above.

Would you like to RESTART, RESTORE a saved game, QUIT or UNDO the last command?

>showme
Please give one of the answers above.

Would you like to RESTART, RESTORE a saved game, QUIT or UNDO the last command?

* * *

>enter elevator
You enter the rickety elevator and as soon as you turn to face the old lift handle, the elevator lurches down a few feet and the door grill slams shut!

You get into elevator.

In elevator you can see lever handle and Bag of bricks.

>n
You can't go that way.

>go in elevator
You can't see any such thing.

>l
Hotel Lobby
An old timey hotel with only one thing of interest -
...a wonky sissor hinge ancient elevator.

* * *

>enter elevator
You enter the rickety elevator and as soon as you turn to face the old lift handle, the elevator lurches down a few feet and the door grill slams shut!

You get into elevator.

In elevator you can see lever handle and Bag of bricks.

>pull lever
the elevator grinds it seems too heavy to move up a few feet back into place.

>take bricks
Taken.

>throw bricks
Dropped.

Oh no you got to get out of here!
Maybe there is a way to reduce the weight

>pull lever
the elevator grinds it seems too heavy to move up a few feet back into place.

Oh no you got to get out of here!
Maybe there is a way to reduce the weight

>throw bricks at hotel lobby
You can't see any such thing.

* * *

>enter elevator
You enter the rickety elevator and as soon as you turn to face the old lift handle, the elevator lurches down a few feet and the door grill slams shut!

You get into elevator.

In elevator you can see lever handle and Bag of bricks.

>showme
Hotel Lobby - room
    elevator - open container
        yourself - person
        lever handle - device
        Bag of bricks

>go inside elevator
You enter the rickety elevator and as soon as you turn to face the old lift handle, the elevator lurchs down a few feet and the door grill slams shut!

* * *

>showme
Hotel Lobby - room
    elevator - open container
        yourself - person
        lever handle - device
        Bag of bricks

>take bricks
Taken.

Oh no you got to get out of here!

>i
You are carrying:
  Bag of bricks

>throw bricks
Dropped.

    *** Whew! You escaped the elevator! ***

Would you like to RESTART, RESTORE a saved game, QUIT or UNDO the last command?

* * *

>take bricks
Taken.

Oh no you got to get out of here!

>throw bricks
Dropped.

Oh no you got to get out of here!
Maybe there is a way to reduce the weight

>l
Hotel Lobby (in elevator)
An old timey hotel with only one thing of interest -
...a wonky sissor hinge ancient paternoster elevator.

In elevator you can see Bag of bricks and lever handle.

Oh no you got to get out of here!
Maybe there is a way to reduce the weight

>throw bag of bricks out of elevator
I only understood you as far as wanting to throw Bag of bricks.

>throw bag of bricks out in hotel lobby
I only understood you as far as wanting to throw Bag of bricks.

>exit elevator
I only understood you as far as wanting to exit.

>leave elevator
I only understood you as far as wanting to leave.

>showme
Hotel Lobby - room
    elevator - open container
        Bag of bricks
        yourself - person
        lever handle - device

>exit
You get out of elevator.

Hotel Lobby
An old timey hotel with only one thing of interest -
...a wonky sissor hinge ancient paternoster elevator.

>hop
You jump on the spot.

* * *

Today is the day! You just know it! You are going to escape the bed!

Escaping A Container
An Interactive Fiction by Alix Leonhart
Release 1 / Serial number 250914 / Inform 7 v10.1.2 / D

Bedroom (in bed)
It's my person's old bedroom

You can see basket (empty) here.

In bed you can see decorative pillow (on which are stuffed animal and pillow mint).

>exit
(elevator)
You are not inside the elevator currently!

>enter elevator
You enter the rickety elevator and as soon as you turn to face the old lift handle, the elevator lurches down a few feet and the door grill slams shut!

You get into elevator.

In elevator you can see lever handle and Bag of bricks.

>exit
(elevator)
Oh no you got to get out of here!
Maybe there is a way to reduce the weight

>exit elevator
Oh no you got to get out of here!
Maybe there is a way to reduce the weight

>enter elevator
But you're already in elevator.

Oh no you got to get out of here!
Maybe there is a way to reduce the weight

>exit elevator
Oh no you got to get out of here!
Maybe there is a way to reduce the weight

>get out of elevator
Oh no you got to get out of here!
Maybe there is a way to reduce the weight

>showme
Hotel Lobby - room
    elevator - open container
        yourself - person
        lever handle - device
        Bag of bricks

* * *

>leave
That's not a verb I recognise.

>enter elevator
But you're already in elevator.

>exit elevator
You can't the elevator door is stuck tight, maybe if the elevator can be raised up to it's normal resting location.

>exit
(elevator)
You can't the elevator door is stuck tight, maybe if the elevator can be raised up to it's normal resting location.

Oh no you got to get out of here!
Maybe there is a way to reduce the weight

>l
Hotel Lobby (in elevator)
An old timey hotel with only one thing of interest -
...a wonky sissor hinge ancient paternoster elevator.

In elevator you can see lever handle and Bag of bricks.

Oh no you got to get out of here!
Maybe there is a way to reduce the weight

>pull lever
It is fixed in place.

Oh no you got to get out of here!
Maybe there is a way to reduce the weight

>push lever
It is fixed in place.

Oh no you got to get out of here!
Maybe there is a way to reduce the weight

>operate lever
the elevator grinds it seems too heavy to move up a few feet back into place.

Oh no you got to get out of here!
Maybe there is a way to reduce the weight

>crank lever
the elevator grinds it seems too heavy to move up a few feet back into place.

Oh no you got to get out of here!
Maybe there is a way to reduce the weight

>pull lever
It is fixed in place.

Oh no you got to get out of here!
Maybe there is a way to reduce the weight

* * *

Today is the day! You just know it! You are going to escape the bed!

Escaping A Container
An Interactive Fiction by Alix Leonhart
Release 1 / Serial number 250914 / Inform 7 v10.1.2 / D

Bedroom (in bed)
It's my person's old bedroom

You can see basket (empty) here.

In bed you can see decorative pillow (on which are stuffed animal and pillow mint).

>fall off bed
There is a basket you can jump into from the bed, but you can't jump from here currently as the landing would be to hard!

* * *

Today is the day! You just know it! You are going to escape the bed!

Escaping A Container
An Interactive Fiction by Alix Leonhart
Release 1 / Serial number 250914 / Inform 7 v10.1.2 / D

Bedroom (in bed)
It's my person's old bedroom

You can see basket (empty) here.

In bed you can see decorative pillow (on which are stuffed animal and pillow mint).

>get in elevator
You enter the rickety elevator and as soon as you turn to face the old lift handle, the elevator lurchs down a few feet and the door grill slams shut!

>exit
But you aren't in anything at the moment.

>exit elevator
I only understood you as far as wanting to exit.

>leave
But you aren't in anything at the moment.

>l
Hotel Lobby
An old timey hotel with only one thing of interest -
...a wonky sissor hinge ancient paternoster elevator.

>enter elevator
You enter the rickety elevator and as soon as you turn to face the old lift handle, the elevator lurchs down a few feet and the door grill slams shut!

>showme
Hotel Lobby - room
    yourself - person
    elevator - open container
        lever handle - device
        Bag of bricks

>enter elevator
You enter the rickety elevator and as soon as you turn to face the old lift handle, the elevator lurchs down a few feet and the door grill slams shut!

* * *

Today is the day! You just know it! You are going to escape the bed!

Escaping A Container
An Interactive Fiction by Alix Leonhart
Release 1 / Serial number 250914 / Inform 7 v10.1.2 / D

Bedroom (in bed)
It's my person's old bedroom

You can see basket (empty) here.

In bed you can see decorative pillow (on which are stuffed animal and pillow mint).

>go in elevator
You enter the rickety elevator and as soon as you turn to face the old lift handle, the door slams shut!

>l
Hotel Lobby
An old timey hotel with only one thing of interest -
...a wonky sissor hinge ancient elevator.

You can see elevator (empty) here.

>exit
But you aren't in anything at the moment.

>enter elevator
You enter the rickety elevator and as soon as you turn to face the old lift handle, the door slams shut!

* * *

Today is the day! You just know it! You are going to escape the bed!

Escaping A Container
An Interactive Fiction by Alix Leonhart
Release 1 / Serial number 250914 / Inform 7 v10.1.2 / D

Bedroom (in bed)
It's my person's old bedroom

You can see basket (empty) here.

In bed you can see decorative pillow (on which are stuffed animal and pillow mint).

>hop
You jump on the spot.

>enter elevator
You enter the rickety elevator and as soon as you turn to face the old lift handle, the elevator lurches down a few feet and the door grill slams shut!

You get into elevator.

In elevator you can see lever handle and Bag of bricks.

>hop
You jump on the spot.

>exit
(elevator)
You can't the elevator door is stuck tight, maybe if the elevator can be raised up to it's normal resting location.

* * *

Today is the day! You just know it! You are going to escape the bed!

Escaping A Container
An Interactive Fiction by Alix Leonhart
Release 1 / Serial number 250914 / Inform 7 v10.1.2 / D

Bedroom (in bed)
It's my person's old bedroom

You can see basket (empty) here.

In bed you can see decorative pillow (on which are stuffed animal and pillow mint).

>hop off bed
There is a basket you can jump into from the bed, but you can't jump from here currently as the landing would be to hard!

* * *

Today is the day! You just know it! You are going to escape the bed!

Escaping A Container
An Interactive Fiction by Alix Leonhart
Release 1 / Serial number 250914 / Inform 7 v10.1.2 / D

Bedroom (in bed)
It's my person's old bedroom

You can see basket (empty) here.

In bed you can see decorative pillow (on which are stuffed animal and pillow mint).

>take bricks
Taken.

* * *

Today is the day! You just know it! You are going to escape the bed!

Escaping A Container
An Interactive Fiction by Alix Leonhart
Release 1 / Serial number 250914 / Inform 7 v10.1.2 / D

Bedroom (in bed)
It's my person's old bedroom

You can see basket (empty) here.

In bed you can see decorative pillow (on which are stuffed animal and pillow mint).

>take candy
Taken.

>give candy to stuffed animal
The Plushie is visibly excited saying "Oh goodness! Thank you so much! Please let me know if I can ever do anything to return the favor!"

>l
Bedroom (in bed)
My old bedroom

You can see basket (empty) here.

In bed you can see decorative pillow (on which is stuffed animal).

>talk to  plushie
You implore the friendly beast of wonkiness to leave the decorative pillow it is set upon
"I am actually quite comfortable here, is there anything you can give me to sweeten the deal?" says the stuffed animal (yes/no)

>yes
Giving the pillow mint over to the stuffed animal plushie,
They say "Aw thank you so much, I'll hop off it now!"

>take pillow
Which do you mean, decorative pillow or pillow mint?

>decorative
Taken.

There must be a way off this bed!
Perhaps you can lure the plushi off the pillow with a treat

>throw pillow at basket
(decorative pillow at basket)
you hurl the decorative pillow the best you can, but it ends up being really more of a tumbling push. It still lands in the basket.

>exit
(bed)
You triumphantly leap from the bed, steeling yourself, waving to the plushie waving and... land softly on the pillow!
Climbing down from the basket you are now on the bedroom floor!

    *** Hooray and Congratulations! You've escaped the bed! ***

Would you like to RESTART, RESTORE a saved game, QUIT or UNDO the last command?

* * *

>give candy to stuffed animal
The Plushie is visibly excited saying "Oh goodness! Thank you so much! Please let me know if I can ever do anything to return the favor!"

>talk to plushie
You implore the friendly beast of wonkiness to leave the decorative pillow it is set upon
"I am actually quite comfortable here, is there anything you can give me to sweeten the deal?" says the stuffed animal (yes/no)

>yes
Giving the pillow mint over to the stuffed animal plushie,
They say "Aw thank you so much, I'll hop off it now!"

* * *

>take pillow
Which do you mean, decorative pillow or pillow mint?

>decorative
You can't reach decorative pillow from here.

>take decorative pillow
You can't reach decorative pillow from here.

There must be a way off this bed!
Perhaps you can lure the plushi off the pillow with a treat

>l
Bedroom (in bed)
My old bedroom

You can see basket (in which is decorative pillow (on which is stuffed animal)) here.

* * *

Today is the day! You just know it! You are going to escape the bed!

Escaping A Container
An Interactive Fiction by Alix Leonhart
Release 1 / Serial number 250914 / Inform 7 v10.1.2 / D

Bedroom (in bed)
It's my person's old bedroom

You can see basket (empty) here.

In bed you can see decorative pillow (on which are stuffed animal and pillow mint).

>take mint
Taken.

>give mint to plushie
The Plushie is visibly excited saying "Oh goodness! Thank you so much! Please let me know if I can ever do anything to return the favor!"

>talk to plushie
You implore the friendly beast of wonkiness to leave the decorative pillow it is set upon
The plushie says "Sure anything for my friend!" and hops down onto the bed.

>no
That was a rhetorical question.

>i
You are carrying nothing.

>throw pillow at basket
Which do you mean, pillow mint or decorative pillow?

>decorative
(first taking decorative pillow)
you hurl the decorative pillow the best you can, but it ends up being really more of a tumbling push. It still lands in the basket.

There must be a way off this bed!
It might be time to try jumping into the basket!

>jump
You jump on the spot.

>jump off bed
You triumphantly leap from the bed, steeling yourself, waving to the plushie waving and... land softly on the pillow!
Climbing down from the basket you are now on the bedroom floor!

    *** Hooray and Congratulations! You've escaped the bed! ***

Would you like to RESTART, RESTORE a saved game, QUIT or UNDO the last command?

* * *

Today is the day! You just know it! You are going to escape the bed!

Escaping A Container
An Interactive Fiction by Alix Leonhart
Release 1 / Serial number 250914 / Inform 7 v10.1.2 / D

Bedroom (in bed)
It's my person's old bedroom

You can see basket (empty) here.

In bed you can see decorative pillow (on which are stuffed animal and pillow mint).

>take plushie
You implore the friendly beast of wonkiness to leave the decorative pillow it is set upon
"I am actually quite comfortable here, is there anything you can give me to sweeten the deal?" says the stuffed animal (yes/no)

* * *

>yes
That was a rhetorical question.

>no
That was a rhetorical question.

>hop
You jump on the spot.

>i
You are carrying nothing.

There must be a way off this bed!
Perhaps you can lure the plushi off the pillow with a treat

>talk to plushie
You implore the friendly beast of wonkiness to leave the decorative pillow it is set upon
"I am actually quite comfortable here, is there anything you can give me to sweeten the deal?" says the stuffed animal (yes/no)

>no
Plushie says "Well then I am not moving!

* * *

Today is the day! You just know it! You are going to escape the bed!

Escaping A Container
An Interactive Fiction by Alix Leonhart
Release 1 / Serial number 250914 / Inform 7 v10.1.2 / D

Bedroom (in bed)
It's my person's old bedroom

You can see basket (empty) here.

In bed you can see decorative pillow (on which are stuffed animal and pillow mint).

>talk to plushie
You implore the friendly beast of wonkiness to leave the decorative pillow it is set upon
"I am actually quite comfortable here, is there anything you can give me to sweeten the deal?" says the stuffed animal (yes/no)

>yes
"Meh and hurmph! You have nothing of interest to my sweet-tooth." says the stuffed animal

>l
Bedroom (in bed)
My old bedroom

You can see basket (empty) here.

In bed you can see decorative pillow (on which are stuffed animal and pillow mint).

>x mint
A small tasty mint candy.

>take mint
Taken.

>talke to plushie
That's not a verb I recognise.

>talk to plushie
You implore the friendly beast of wonkiness to leave the decorative pillow it is set upon
"I am actually quite comfortable here, is there anything you can give me to sweeten the deal?" says the stuffed animal (yes/no)

>yes
Giving the pillow mint over to the stuffed animal plushie,
They say "Aw thank you so much, I'll hop off it now!"

There must be a way off this bed!
Perhaps you can lure the plushi off the pillow with a treat

>exit
(bed)
There is a basket you can jump into from the bed, but you can't jump from here currently as the landing would be to hard!

>jump off bed
There is a basket you can jump into from the bed, but you can't jump from here currently as the landing would be to hard!

>jump off bed
There is a basket you can jump into from the bed, but you can't jump from here currently as the landing would be to hard!

>exit
(bed)
There is a basket you can jump into from the bed, but you can't jump from here currently as the landing would be to hard!

>l
Bedroom (in bed)
My old bedroom

You can see basket (empty) here.

In bed you can see decorative pillow (on which is stuffed animal).

There must be a way off this bed!
Perhaps you can lure the plushi off the pillow with a treat

>i
You are carrying nothing.

>talk to pl;ushie
You can't see any such thing.

>talk to plushie
You implore the friendly beast of wonkiness to leave the decorative pillow it is set upon
The plushie says "Sure anything for my friend!"

>l
Bedroom (in bed)
My old bedroom

You can see basket (empty) here.

In bed you can see stuffed animal and decorative pillow.

>take pillow
Which do you mean, pillow mint or decorative pillow?

>mint
That seems to belong to stuffed animal.

>take pillow
Which do you mean, pillow mint or decorative pillow?

>decorative
Taken.

There must be a way off this bed!
Perhaps the pillow in the basket would make it soft enough to land a jump.

>take decorative pillow
You already have that.

>throw pillow at basket
(decorative pillow at basket)
you hurl the decorative pillow the best you can, but it ends up being really more of a tumbling push. It still lands in the basket.

Futile.

>toss pillow
Which do you mean, decorative pillow or pillow mint?

>toss pillow at basket
Which do you mean, decorative pillow or pillow mint?

>jump off bed
You triumphantly leap from the bed, steeling yourself, waving to the plushie waving and... 
 land softly on the pillow!
Climbing down fromthe basket you are now on the bedroom floor!

Bedroom
My old bedroom

You can see basket (in which is decorative pillow) here.

    *** Hooray and Congratulations! You've escaped the bed! ***

Would you like to RESTART, RESTORE a saved game, QUIT or UNDO the last command?

>exit
Please give one of the answers above.

Would you like to RESTART, RESTORE a saved game, QUIT or UNDO the last command?

>l
Please give one of the answers above.

Would you like to RESTART, RESTORE a saved game, QUIT or UNDO the last command?

>i
Please give one of the answers above.

Would you like to RESTART, RESTORE a saved game, QUIT or UNDO the last command?

>throw decorative pillow at basket
Please give one of the answers above.

Would you like to RESTART, RESTORE a saved game, QUIT or UNDO the last command?

* * *

Today is the day! You just know it! You are going to escape the bed!

Escaping A Container
An Interactive Fiction by Alix Leonhart
Release 1 / Serial number 250914 / Inform 7 v10.1.2 / D

Bedroom (in bed)
It's my person's old bedroom

You can see basket (empty) here.

In bed you can see decorative pillow (on which are stuffed animal and pillow mint).

>x pillow
Which do you mean, decorative pillow or pillow mint?

>decorative pillow
An aesthetic, if uncomfortable, pillow in a cross-stitched sham.

On decorative pillow are stuffed animal and pillow mint.

>x sham
You can't see any such thing.

>x animal
A cute & quirky anthropomorphized creature.

>take animal
You implore the friendly beast of wonkiness to leave the decorative pillow it is set upon
"I am actually quite comfortable here, is there anything you can give me to sweeten the deal?" says the stuffed animal (yes/no)

>no
Plushie says "Well then I am not moving!

>take mint
Taken.

>take animal
You implore the friendly beast of wonkiness to leave the decorative pillow it is set upon
"I am actually quite comfortable here, is there anything you can give me to sweeten the deal?" says the stuffed animal (yes/no)

>yes
Giving the pillow mint over to the stuffed animal plushie,
They say "Aw thank you so much, I'll hop off it now!"

>x
(basket)
A laundry basket beside the bed.

There must be a way off this bed!
Perhaps you can lure the plushi off the pillow with a treat

>x animal
A cute & quirky anthropomorphized creature.

>x pillow
Which do you mean, decorative pillow or pillow mint?

>decorative
An aesthetic, if uncomfortable, pillow in a cross-stitched sham.

On decorative pillow is stuffed animal.

>x mint
A small tasty mint candy.

>take mint
That seems to belong to stuffed animal.

>talk to animal
You implore the friendly beast of wonkiness to leave the decorative pillow it is set upon
The plushie says "Sure anything for my friend!" and hops down onto the bed.

>x animal
A cute & quirky anthropomorphized creature.

There must be a way off this bed!
Perhaps the pillow in the basket would make it soft enough to land a jump.

>push pillow
Which do you mean, pillow mint or decorative pillow?

>decorative
Nothing obvious happens.

>take pillow
Which do you mean, pillow mint or decorative pillow?

>decorative
Taken.

>toss pillow into basket
I didn't understand that sentence.

>toss pillow
(decorative pillow at decorative pillow)
Futile.

>toss decorative pillow at basket
you hurl the decorative pillow the best you can, but it ends up being really more of a tumbling push. It still lands in the basket.

>jump into basket
I only understood you as far as wanting to jump.

>jump at basket
I only understood you as far as wanting to jump.

>jump to basket
I only understood you as far as wanting to jump.

>jump off bed
You triumphantly leap from the bed, steeling yourself, waving to the plushie waving and... land softly on the pillow!
Climbing down from the basket you are now on the bedroom floor!

    *** Hooray and Congratulations! You've escaped the bed! ***

Would you like to RESTART, RESTORE a saved game, QUIT or UNDO the last command?