What Rocky Does When No One's Around
An Interactive Fiction by Emily Seifert
Release 1 / Serial number 251008 / Inform 7 v10.1.2 / D

Bedroom (in the Bed)
The room where the human resides for most of her time during the school year. It's cozy. A galaxy themed aesthetic fills the bedsheets on the bed in which you and your fellow plushies lay on top of. The human is gone until 3pm, including her roommates. 

The way to leave the room is to the north. It's time to explore.

I beg your pardon?

I beg your pardon?

>i
You are carrying nothing.

>i
You are carrying nothing.

>ii
That's not a verb I recognise.

>i
You are carrying nothing.

>iiii
That's not a verb I recognise.

I beg your pardon?

* * *

>i
You are carrying nothing.

I beg your pardon?

* * *

>ii
That's not a verb I recognise.

I beg your pardon?

>ii
That's not a verb I recognise.

* * *

>i
You are carrying nothing.

>k
That's not a verb I recognise.

>i
You are carrying nothing.

>i
You are carrying nothing.

    *** It's 3pm! The human is home from school!
You stop whatever you were doing and go limp. 

 "Huh. Looks like you had a fun day." she says as she picks you up and places you back on the bed. She gently pets you're head before going back to work.

 Today was a good day! ***

Would you like to RESTART, RESTORE a saved game, QUIT or UNDO the last command?

>restart
What Rocky Does When No One's Around
An Interactive Fiction by Emily Seifert
Release 1 / Serial number 251007 / Inform 7 v10.1.2 / D

Bedroom (in the Bed)
The room where the human resides for most of her time during the school year. It's cozy. A galaxy themed aesthetic fills the bedsheets on the bed in which you and your fellow plushies lay on top of. The human is gone until 3pm, including her roommates. 

The way to leave the room is to the north. It's time to explore.

On the Desk is Laptop.

In the Bed you can see Pillows (on which is Plushies) and Rabbit.

* * *

I beg your pardon?

>sit chair
You hoist your body onto the seat and get on the chair. You reposition yourself so you're facing the desk.

Bedroom (on Chair)
The room where the human resides for most of her time during the school year. 

The way to leave the room is to the north. It's time to explore.

On the Desk is Laptop.

>use laptop
You open up the laptop and turn it on. It is just a bit slow like the human says it is, but it's still perfectly functional.
 You find yourself flumbing on here for hours.

 You don't know how it happened, but you end up watching an hour long deep dive video about a long gone childrens game. Time was lost to you.

* * *

What Rocky Does When No One's Around
An Interactive Fiction by Emily Seifert
Release 1 / Serial number 251008 / Inform 7 v10.1.2 / D

Bedroom (in the Bed)
The room where the human resides for most of her time during the school year. It's cozy. A galaxy themed aesthetic fills the bedsheets on the bed in which you and your fellow plushies lay on top of. The human is gone until 3pm, including her roommates. 

The way to leave the room is to the north. It's time to explore.

>Talk rabbit
"You appraoch the brown-grey rabbit instead. 
 Hi Rocky! What do you need?" the rabbit says.

 You politely ask the rabbit for him and the others plushies to leave the pillows so you can use them.

 "Oh! Okay! It would probably be a good change of scenery." it says as it convinces the others to leave. "Good luck with whatever you're doing! :)"

>take pillows
Now that your friends are no longer on the pillows, you take them.

>throw pillows
one by one you toss the pillows over the edge of the bed. They seemed to have made quite the pile to break your stuffed fall.

>jump off ned
I only understood you as far as wanting to jump.

>jump off bed
You jump on the pile of pillows as they cushion your fall to the floor.

Bedroom
The room where the human resides for most of her time during the school year. 

The way to leave the room is to the north. It's time to explore.

On the Desk is Laptop.

You can also see Pillows here.

>take pillows
you take them.

>unlock door
You place the pillow on the side of the door, and stand on top of it. You're able to reach the doorknob and open the door to the hallway.

>n
(first opening Bedroom door)

hallway
 Yup, its a hallway. There's a beam in the middle of the space. Someone could run into that!  You can go west to the area of Skull Kid's room or east to where the living room and Monster Kid's room are.

>drop pillows
Dropped.

>w
Path 1
Skull Kid's room is to the south.

>s
Skull Kid's Room
 It's full of skull and meme memorabilia. Whatever a "meme" is you don't know.  There's a few of your stuffed friends on the bed in here. The hallway is north of here.

You can see Dog Boy here.

>get on bed
You get onto Skull Kid's Bed.

>get on skull kids bed
You can't see any such thing.

>nap
(Dog Boy)
there's no good place to nap right now.

>leave
(Dog Boy)

* * *

What Rocky Does When No One's Around
An Interactive Fiction by Emily Seifert
Release 1 / Serial number 251008 / Inform 7 v10.1.2 / D

Bedroom (in the Bed)
The room where the human resides for most of her time during the school year. It's cozy. A galaxy themed aesthetic fills the bedsheets on the bed in which you and your fellow plushies lay on top of. The human is gone until 3pm, including her roommates. 

The way to leave the room is to the north. It's time to explore.

>exit
(the Bed)
You may be made of fluff, but that would hurt!

>leave
You may be made of fluff, but that would hurt!

* * *

What Rocky Does When No One's Around
An Interactive Fiction by Emily Seifert
Release 1 / Serial number 251008 / Inform 7 v10.1.2 / D

Bedroom (in the Bed)
The room where the human resides for most of her time during the school year. It's cozy. A galaxy themed aesthetic fills the bedsheets on the bed in which you and your fellow plushies lay on top of. The human is gone until 3pm, including her roommates. 

The way to leave the room is to the north. It's time to explore.

>grab pillows
You don't want to move them when your plush friends are on top!

>look plushies
There's a variety of little plush toys placed gently on each pillow.  They range from two tiny foxes, a white dog with a red target for an eye, and 4 bunnies of different shapes and sizes. The thin brown and grey rabbit sitting in front of the first pillow seems the most reasonable to talk to.

>talk plushies
As you attempt to ask the plushies to move, the white branded dog on top of the hoard interjects 
 "Hey!" he says, "We aren't gonna move just because you asked us!!"

 "Yeah! The foxes and smaller rabbits say, "We only follow what each other here on the pillows say! 

 It looks as if you might need to find a more reasonable plushie.

* * *

What Rocky Does When No One's Around
An Interactive Fiction by Emily Seifert
Release 1 / Serial number 251008 / Inform 7 v10.1.2 / D

Bedroom (in the Bed)
The room where the human resides for most of her time during the school year. It's cozy. A galaxy themed aesthetic fills the bedsheets on the bed in which you and your fellow plushies lay on top of. The human is gone until 3pm, including her roommates. 

The way to leave the room is to the north. It's time to explore.

>hop
You jump on the spot.

>look
Bedroom (on the Bed)
The room where the human resides for most of her time during the school year. 

The way to leave the room is to the north. It's time to explore.

You can see Pillows here.

>look bed
You are on the bed, there are other plushies on the pillows behind you.

>look pillows
(Pillows)
You see nothing special about Pillows.

>look plushies
You can't see any such thing.

* * *

>hop
You jump on the spot.

>run
You'll have to say which compass direction to go in.

>s
You can't go that way.

>n
You can't go that way.

>w
You can't go that way.

>e
You can't go that way.

>ne
You can't go that way.

>sleep
You aren't feeling especially drowsy.

>sit
What do you want to sit on?

>sit ground
I didn't understand that sentence.

>sit on ground
You can't see any such thing.

>sit on floor
You can't see any such thing.

>look
Example Location

>sit on chait
You can't see any such thing.

* * *

What Rocky Does When No One's Around
An Interactive Fiction by Emily Seifert
Release 1 / Serial number 251008 / Inform 7 v10.1.2 / D

Bedroom (in the Bed)
The room where the human resides for most of her time during the school year. It's cozy. A galaxy themed aesthetic fills the bedsheets on the bed in which you and your fellow plushies lay on top of. The human is gone until 3pm, including her roommates. 

The way to leave the room is to the north. It's time to explore.

>i
You are carrying nothing.

>talk rabbit
"You appraoch the brown-grey rabbit instead. 
 Hi Rocky! What do you need?" the rabbit says.

 You politely ask the rabbit for him and the others plushies to leave the pillows so you can use them.

 "Oh! Okay! It would probably be a good change of scenery." it says as it convinces the others to leave. "Good luck with whatever you're doing! :)"

>take pillows
Now that your friends are no longer on the pillows, you take them.

>i
You are carrying:
  Pillows

* * *

What Rocky Does When No One's Around
An Interactive Fiction by Emily Seifert
Release 1 / Serial number 251008 / Inform 7 v10.1.2 / D

Bedroom (in the Bed)
The room where the human resides for most of her time during the school year. It's cozy. A galaxy themed aesthetic fills the bedsheets on the bed in which you and your fellow plushies lay on top of. The human is gone until 3pm, including her roommates. 

The way to leave the room is to the north. It's time to explore.

>leave
You get out of the Bed.

Bedroom
The room where the human resides for most of her time during the school year. 

The way to leave the room is to the north. It's time to explore.

On the Desk is Laptop.

>look desk
It's a bit messy, but yet organized. The laptop is the only thing that peaks your curiosity.

On the Desk is Laptop.

>look laptop
It's a medium sized silver laptop with a lot of silly stickers plastered on top. It's amazing how many of these were able to survive being transferred between the old one and the current one.

>use laptop
You need to be able use to reach the desk first. Maybe use the chair in front of the desk.

>look chair
It's a wooden chair with a cushioned seat and backing. You're just tall enough to climb on top.

>sit chair
You hoist your body onto the seat and get on the chair. You reposition yourself so you're facing the desk.

Bedroom (on Chair)
The room where the human resides for most of her time during the school year. 

The way to leave the room is to the north. It's time to explore.

On the Desk is Laptop.

* * *

What Rocky Does When No One's Around
An Interactive Fiction by Emily Seifert
Release 1 / Serial number 251008 / Inform 7 v10.1.2 / D

Bedroom (in the Bed)
The room where the human resides for most of her time during the school year. It's cozy. A galaxy themed aesthetic fills the bedsheets on the bed in which you and your fellow plushies lay on top of. The human is gone until 3pm, including her roommates. 

The way to leave the room is to the north. It's time to explore.

>look
Bedroom
The room where the human resides for most of her time during the school year. 

The way to leave the room is to the north. It's time to explore.

>look bed
You are on the bed, there are other plushies on the pillows behind you.

>look desk
On the desk is Laptop.

* * *

>look bed
You are on the bed, there are other plushies on the pillows behind you.

>look pillows
You can't see any such thing.

* * *

>look
Bedroom
The room where the human resides for most of her time during the school year. 

The way to leave the room is to the north. It's time to explore.

>pillows
That's not a verb I recognise.

* * *

What Rocky Does When No One's Around
An Interactive Fiction by Emily Seifert
Release 1 / Serial number 251008 / Inform 7 v10.1.2 / D

Bedroom (in the Bed)
The room where the human resides for most of her time during the school year. It's cozy. A galaxy themed aesthetic fills the bedsheets on the bed in which you and your fellow plushies lay on top of. The human is gone until 3pm, including her roommates. 

The way to leave the room is to the north. It's time to explore.

>look bed
You are on the bed, there are other plushies on the pillows behind you.

>look pillow
You can't see any such thing.

* * *

>look bed
You are on the bed, there are other plushies on the pillows behind you.

>look pillows
There are 4 pillows neatly stacked in front of each other. They could make for some good cushions if not for your friends on top.

On Pillows is Plushies.

>look plushies
There's a variety of little plush toys placed gently on each pillow.  They range from two tiny foxes, a white dog with a red target for an eye, and 4 bunnies of different shapes and sizes. The thin brown and grey rabbit sitting in front of the first pillow seems the most reasonable to talk to.

>look rabbit
It's the plushie sitting in front of the pillows, it looks reasonable to talk to.

* * *

>look plushies
There's a variety of little plush toys placed gently on each pillow.  They range from two tiny foxes, a white dog with a red target for an eye, and 4 bunnies of different shapes and sizes. The thin brown and grey rabbit sitting in front of the first pillow seems the most reasonable to talk to.

>talk to rabbit
"Hi Rocky! What do you need?" the rabbit says.
 You politely ask the rabbit and the others plushies to leave the pillows so you can use them.

 "Oh! Okay! Good luck with whatever you're doing! :)"

>take pillows
Now that your friends are no longer on the pillows, you take them.

* * *

>throw pillows
one by one you toss the pillows over the edge of the bed. They seemed to have made quite the pile to break your stuffed fall.

>n
You would have to get out of the Bed first.

>leave
You get out of the Bed.

Bedroom
The room where the human resides for most of her time during the school year. 

The way to leave the room is to the north. It's time to explore.

On the Desk is Laptop.

You can also see Pillows, Rabbit and Chair here.

* * *

>look pillows
There are 4 pillows neatly stacked in front of each other. They could make for some good cushions if not for your friends on top.

On Pillows is Plushies.

>take pillows
You don't want to move them when your plush friends are on top!

>look plushies
There's a variety of little plush toys placed gently on each pillow. They range from two tiny foxes, a white dog with a red target for an eye, and 4 bunnies of different shapes and sizes. The thin brown and grey rabbit sitting in front of the first pillow seems the most reasonable to talk to.

>look rabbit
It's the plushie sitting in front of the pillows, it looks reasonable to talk to.

>talk to rabbit
"Hi Rocky! What do you need?" the rabbit says.
 You politely ask the rabbit and the others plushies to leave the pillows so you can use them.

 "Oh! Okay! Good luck with whatever you're doing! :)"

* * *

>take pillows
Now that your friends are no longer on the pillows, you take them.

>throw pillows
(first taking Pillows)
Now that your friends are no longer on the pillows, you take them.

* * *

>look bed
You are on the bed, there are other plushies on the pillows behind you.

>take pillows
That's hardly portable.

* * *

What Rocky Does When No One's Around
An Interactive Fiction by Emily Seifert
Release 1 / Serial number 251008 / Inform 7 v10.1.2 / D

Bedroom (in the Bed)
The room where the human resides for most of her time during the school year. It's cozy. A galaxy themed aesthetic fills the bedsheets on the bed in which you and your fellow plushies lay on top of. The human is gone until 3pm, including her roommates. 

The way to leave the room is to the north. It's time to explore.

>look ned
You can't see any such thing.

>look be
You can't see any such thing.

>look bed
You are on the bed, there are other plushies on the pillows behind you.

On the Bed is Pillows (on which is Plushies).

* * *

What Rocky Does When No One's Around
An Interactive Fiction by Emily Seifert
Release 1 / Serial number 251008 / Inform 7 v10.1.2 / D

Bedroom (in the Bed)
The room where the human resides for most of her time during the school year. It's cozy. A galaxy themed aesthetic fills the bedsheets on the bed in which you and your fellow plushies lay on top of. The human is gone until 3pm, including her roommates. 

The way to leave the room is to the north. It's time to explore.

>look pillows
There are 4 pillows neatly stacked in front of each other. They could make for some good cushions if not for your friends on top.

On Pillows is Plushies.

>look bed
You are on the bed, there are other plushies on the pillows behind you.

* * *

>look pillows
There are 4 pillows neatly stacked in front of each other. They could make for some good cushions if not for your friends on top.

On Pillows is Plushies.

>look plushiws
You can't see any such thing.

>look plushies
There's a variety of little plush toys placed gently on each pillow. They range from two tiny foxes, a white dog with a red target for an eye, and 4 bunnies of different shapes and sizes. The thin brown and grey rabbit sitting in front of the first pillow seems the most reasonable to talk to.

* * *

>look rabbit
It's the plushie sitting in front of the pillows, it looks reasonable to talk to.

>talk rabbit
I didn't understand that sentence.

>talk to rabbit
"Hi Rocky! What do you need?" the rabbit says. You politely ask the rabbit and the others plushies to leave the pillows so you can use them. "Oh! Okay! Good luck with whatever you're doing! :)"

>take pillows
Now that your friends are no longer on the pillows, you take them.

* * *

What Rocky Does When No One's Around
An Interactive Fiction by Emily Seifert
Release 1 / Serial number 251008 / Inform 7 v10.1.2 / D

Bedroom (in the Bed)
The room where the human resides for most of her time during the school year. It's cozy. A galaxy themed aesthetic fills the bedsheets on the bed in which you and your fellow plushies lay on top of. The human is gone until 3pm, including her roommates. 

The way to leave the room is to the north. It's time to explore.

>look pillowz
You can't see any such thing.

>look pillows
(Pillows)
There are 4 pillows neatly stacked in front of each other. They could make for some good cushions if not for your friends on top.

* * *

What Rocky Does When No One's Around
An Interactive Fiction by Emily Seifert
Release 1 / Serial number 251008 / Inform 7 v10.1.2 / D

Bedroom (in the Bed)
The room where the human resides for most of her time during the school year. It's cozy. A galaxy themed aesthetic fills the bedsheets on the bed in which you and your fellow plushies lay on top of. The human is gone until 3pm, including her roommates. 

The way to leave the room is to the north. It's time to explore.

>look plushies
There's a variety of little plush toys placed gently on each pillow.  They range from two tiny foxes, a white dog with a red target for an eye, and 4 bunnies of different shapes and sizes. The thin brown and grey rabbit sitting in front of the first pillow seems the most reasonable to talk to.

>talk rabbit
I didn't understand that sentence.

>look rabbi
You can't see any such thing.

>look rabbit
It's the plushie sitting in front of the pillows, it looks reasonable to talk to.

* * *

What Rocky Does When No One's Around
An Interactive Fiction by Emily Seifert
Release 1 / Serial number 251008 / Inform 7 v10.1.2 / D

Bedroom (in the Bed)
The room where the human resides for most of her time during the school year. It's cozy. A galaxy themed aesthetic fills the bedsheets on the bed in which you and your fellow plushies lay on top of. The human is gone until 3pm, including her roommates. 

The way to leave the room is to the north. It's time to explore.

>n
You would have to get out of the Bed first.

>e
Path 2
This is where Monster Kid's room is.

>e
You can't go that way.

>n
Living room
It's a wide open space that includes a couch and even at tv! For some reason, there is a ballpit here.

>n
Entrance

* * *

>n
Living room
It's a wide open space that includes a couch and even at tv! For some reason, there is a ballpit here.

>w
Kitchen
It's connected to the living room. The sink has apparently been leaking since you moved in. You wonder what it would be like to try to make some food.

>e
Living room
It's a wide open space that includes a couch and even at tv! For some reason, there is a ballpit here.

* * *

>e
Path 2
This is where Monster Kid's room is.

>s
Monster Kid's Room
It's pretty bare bones. There's a few scary looking monster figures on the dresser and the windowsill, fake plants are scattered around as well. You don't know why you walked in here...

>n
Path 2
This is where Monster Kid's room is.

>w
Hallway
Yup, its a hallway. There's a beam in the middle of the space. Someone could run into that!

>w
Path 1
This is where Skull Kid's room is.

>n
You can't go that way.

>s
Skull Kid's Room
It's full of skull and meme memorabilia. Whatever a "meme" is you don't know. There's a few of your stuffed friends in here.

>n
Path 1
This is where Skull Kid's room is.

* * *

>n
You would have to get out of the Bed first.

>leave
You may be made of fluff, but that would hurt!

>jump
You jump on the spot.

>jump off bed
You may be made of fluff, but that would hurt!

>look bed
You are on the bed, there are other plushies on the pillows behind you.

In the Bed are Pillows and Rabbit.

>look pillows
There are 4 pillows neatly stacked in front of each other. They could make for some good cushions if not for your friends on top.

On Pillows is Plushies.

* * *

>look plushies
There's a variety of little plush toys placed gently on each pillow.  They range from two tiny foxes, a white dog with a red target for an eye, and 4 bunnies of different shapes and sizes. The thin brown and grey rabbit sitting in front of the first pillow seems the most reasonable to talk to.

>talk plushies
As you attempt to ask the plushies to move, the white branded dog on top of the hoard interjects 
 "Hey!" he says, "We aren't gonna move just because you asked us!!"

 "Yeah! The foxes and smaller rabbits say, "We only follow what eachother here on the pillows say! 

 It looks as if you might need to find a more reasonable plushie.

>look rabbit
It's the plushie sitting in front of the pillows, it looks reasonable to talk to.

>talk rabbit
"You appraoch the brown-grey rabbit instead. 
 Hi Rocky! What do you need?" the rabbit says.

 You politely ask the rabbit for him and the others plushies to leave the pillows so you can use them.

 "Oh! Okay! It would probably be a good change of scenery." it says as it convinces the others to leave. "Good luck with whatever you're doing! :)"

* * *

>throw pillows
one by one you toss the pillows over the edge of the bed. They seemed to have made quite the pile to break your stuffed fall.

>jump off bef
I only understood you as far as wanting to jump.

>jump off bed
You jump on the pile of pillows as they cushion your fall to the floor.

Bedroom
The room where the human resides for most of her time during the school year. 

The way to leave the room is to the north. It's time to explore.

On the Desk is Laptop.

You can also see Pillows here.

>desk
That's not a verb I recognise.

>look desk
It's a bit messy, but yet organized. The laptop is the only thing that peaks your curiosity.

On the Desk is Laptop.

>look chair
It's a wooden chair with a cushioned seat and backing. You're just tall enough to climb on top.

>sit chair
You hoist your body onto the seat and get on the chair. You reposition yourself so you're facing the desk.

Bedroom (on Chair)
The room where the human resides for most of her time during the school year. 

The way to leave the room is to the north. It's time to explore.

On the Desk is Laptop.

You can also see Pillows here.

>use laptop
You open up the laptop and turn it on. It is just a bit slow like the human says it is, but it's still perfectly functional.
 You find yourself flumbing on here for hours.

 You don't know how it happened, but you end up watching an hour long deep dive video about a long gone childrens game. Time was lost to you.

* * *

>n
You would have to get out of the Bed first.

>s
Bedroom
The room where the human resides for most of her time during the school year. 

The way to leave the room is to the north. It's time to explore.

On the Bed is Pillows (on which is Plushies).

On the Desk is Laptop.

You can also see Rabbit here.

>n
Hallway
 You can go west to the area of Skull Kid's room or east to where the living room and Monster Kid's room are.

* * *

>s
Bedroom
The room where the human resides for most of her time during the school year. 

The way to leave the room is to the north. It's time to explore.

On the Bed is Pillows (on which is Plushies).

On the Desk is Laptop.

You can also see Rabbit here.

>s
You can't go that way.

>bed
That's not a verb I recognise.

>look bed
You are on the bed, there are other plushies on the pillows behind you.

On the Bed is Pillows (on which is Plushies).

>look pillows
There are 4 pillows neatly stacked in front of each other. They could make for some good cushions if not for your friends on top.

On Pillows is Plushies.

* * *

>n
You would have to get out of the Bed first.

>w
Path 1
Skull Kid's room is to the south.

>s
Skull Kid's Room
 It's full of skull and meme memorabilia. Whatever a "meme" is you don't know.  There's a few of your stuffed friends on the bed in here.

You can see Dog Boy here.

>look bed
 The bedding is black with white skulls, and has red sheets underneath. Of all the plushies that reside on top when Skull Kid is gone, Dog Boy, the rotund golden retreiver, is the one you talk to the most.

* * *

What Rocky Does When No One's Around
An Interactive Fiction by Emily Seifert
Release 1 / Serial number 251008 / Inform 7 v10.1.2 / D

Bedroom (in the Bed)
The room where the human resides for most of her time during the school year. It's cozy. A galaxy themed aesthetic fills the bedsheets on the bed in which you and your fellow plushies lay on top of. The human is gone until 3pm, including her roommates. 

The way to leave the room is to the north. It's time to explore.

>off bed
That's not a verb I recognise.

>Jump off bed
You may be made of fluff, but that would hurt!

>Climb down bed
I only understood you as far as wanting to climb down.

>Climb down
You must name something more substantial.

>Look bed
You are on the bed, there are other plushies on the pillows behind you.

In the Bed are Pillows and Rabbit.

* * *

>On floor
That's not a verb I recognise.

* * *

>Place ground
That's not a verb I recognise.

>Grab pillow
That's not a verb I recognise.

>Pick up pillow
You can't reach Pillow from here.

>Talk to Rabbit
"You appraoch the brown-grey rabbit instead. 
 Hi Rocky! What do you need?" the rabbit says.

 You politely ask the rabbit for him and the others plushies to leave the pillows so you can use them.

 "Oh! Okay! It would probably be a good change of scenery." it says as it convinces the others to leave. "Good luck with whatever you're doing! :)"

>Grab pillow
That's not a verb I recognise.

>Take pillow
You can't reach Pillow from here.

>Take pillows
Now that your friends are no longer on the pillows, you take them.

I beg your pardon?

>Put pillow on ground
You can't see any such thing.

>Put pillows on ground
You can't see any such thing.

>Place pillows
That's not a verb I recognise.

>Pillows ground
That's not a verb I recognise.

>Throw pillows
one by one you toss the pillows over the edge of the bed. They seemed to have made quite the pile to break your stuffed fall.

>Jump pillow
I only understood you as far as wanting to jump.

>Jump
You jump on the spot.

>Explore
That's not a verb I recognise.

>Look at desk
It's a bit messy, but yet organized. The laptop is the only thing that peaks your curiosity.

On the Desk is Laptop.

>Jump on chair
I only understood you as far as wanting to jump.

>Jump off bed
You jump on the pile of pillows as they cushion your fall to the floor.

Bedroom
The room where the human resides for most of her time during the school year. 

The way to leave the room is to the north. It's time to explore.

On the Desk is Laptop.

You can also see Pillows here.

>Walk to desk
You can't see any such thing.

>Go to desk
You can't see any such thing.

>Walk desk
That's not something you can enter.

>Go desk
That's not something you can enter.

>Walk door
(first opening Bedroom door)
It seems to be locked.

>Walk to desk
You can't see any such thing.

>Go to drawer
You can't see any such thing.

>unlock door
You're just too short to reach the doorknob. Maybe there's something you can stand on.

>Bring pillows
That's not a verb I recognise.

>Grab pillows
That's not a verb I recognise.

>Pick up pillow
That's hardly portable.

>Pick up pillows
you take them.

>place near door
That's not a verb I recognise.

>put pillows by door
I didn't understand that sentence.

>put pillows on door
Putting things on Bedroom door would achieve nothing.

>Unlock door
You place the pillow on the side of the door, and stand on top of it. You're able to reach the doorknob and open the door to the hallway.

>Leave
(the Bed)
You jump on the pile of pillows as they cushion your fall to the floor.

Bedroom
The room where the human resides for most of her time during the school year. 

The way to leave the room is to the north. It's time to explore.

On the Desk is Laptop.

>North
(first opening Bedroom door)

hallway
 Yup, its a hallway. There's a beam in the middle of the space. Someone could run into that!  You can go west to the area of Skull Kid's room or east to where the living room and Monster Kid's room are.

>east
Path 2
Monster Kid's room is south. The living room is north of here.

>North
Living room
It's a wide open space that includes a couch and even at tv! For some reason, there is a ballpit here. The connected kitchen is west of here.

On Coffee table is Tv remote.

>Go to coffee table
You can't see any such thing.

>go to couch
You can't see any such thing.

>West
Kitchen
It's connected to the wide open space that is living room. The sink has apparently been leaking since you moved in. Getting a snack sounds good right about now.

You can see Fridge (empty) and Stove here.

>Stove
That's not a verb I recognise.

>Use Stove
You'd burn if you use that.

>Use stove
You'd burn if you use that.

* * *

>grab snack
That's not a verb I recognise.

>East
Living room
It's a wide open space that includes a couch and even at tv! For some reason, there is a ballpit here. The connected kitchen is west of here.

On Coffee table is Tv remote.

>south
Path 2
Monster Kid's room is south. The living room is north of here.

>Open door
You can't see any such thing.

>south
Monster Kid's Room
It's pretty bare bones. There's a few scary looking monster figures on the dresser and the windowsill, fake plants are scattered around as well.  You don't know why you walked in here...

You can see Spinny Chair here.

>Go on spinny chair
You can't see any such thing.

>Sit on spinny chair
That's not something you can sit down on.

>Sit spinny chair
You hoist your body onto the seat and get on the chair. You reposition yourself so you're facing the desk.

Bedroom (on Chair)
The room where the human resides for most of her time during the school year. 

The way to leave the room is to the north. It's time to explore.

On the Desk is Laptop.

 It apppears this chair caught your attention, it's different the one the human has. With nothing better to do you climb onto this special chair. It spins slightly in your struggle to get up. You wonder what that could mean.

>north
(first getting off Chair)
You jump on the pile of pillows as they cushion your fall to the floor.

Bedroom
The room where the human resides for most of her time during the school year. 

The way to leave the room is to the north. It's time to explore.

On the Desk is Laptop.

hallway
 You can go west to the area of Skull Kid's room or east to where the living room and Monster Kid's room are.

>west
Path 1
Skull Kid's room is to the south.

>south
Skull Kid's Room
 It's full of skull and meme memorabilia. Whatever a "meme" is you don't know.  There's a few of your stuffed friends on the bed in here.

You can see Dog Boy here.

* * *

>spin
(Pillows)
Why would you need to spin right now?

>go on bed
You can't see any such thing.

* * *

>throw pillows
one by one you toss the pillows over the edge of the bed. They seemed to have made quite the pile to break your stuffed fall.

* * *

What Rocky Does When No One's Around
An Interactive Fiction by Emily Seifert
Release 1 / Serial number 251008 / Inform 7 v10.1.2 / D

Bedroom (in the Bed)
The room where the human resides for most of her time during the school year. It's cozy. A galaxy themed aesthetic fills the bedsheets on the bed in which you and your fellow plushies lay on top of. The human is gone until 3pm, including her roommates. 

The way to leave the room is to the north. It's time to explore.

>spin
What do you want to spin?

>spin chair
Why would you need to spin right now?

* * *

What Rocky Does When No One's Around
An Interactive Fiction by Emily Seifert
Release 1 / Serial number 251008 / Inform 7 v10.1.2 / D

Bedroom (in the Bed)
The room where the human resides for most of her time during the school year. It's cozy. A galaxy themed aesthetic fills the bedsheets on the bed in which you and your fellow plushies lay on top of. The human is gone until 3pm, including her roommates. 

The way to leave the room is to the north. It's time to explore.

>take laptop
You can't reach Laptop from here.

* * *

What Rocky Does When No One's Around
An Interactive Fiction by Emily Seifert
Release 1 / Serial number 251008 / Inform 7 v10.1.2 / D

Bedroom (in the Bed)
The room where the human resides for most of her time during the school year. It's cozy. A galaxy themed aesthetic fills the bedsheets on the bed in which you and your fellow plushies lay on top of. The human is gone until 3pm, including her roommates. 

The way to leave the room is to the north. It's time to explore.

>take pillow
(Pillows)
You don't want to move them when your plush friends are on top!

>talk rabbit
"You appraoch the brown-grey rabbit instead. 
 Hi Rocky! What do you need?" the rabbit says.

 You politely ask the rabbit for him and the others plushies to leave the pillows so you can use them.

 "Oh! Okay! It would probably be a good change of scenery." it says as it convinces the others to leave. "Good luck with whatever you're doing! :)"

* * *

>throw pillows
one by one you toss the pillows over the edge of the bed. They seemed to have made quite the pile to break your stuffed fall.

>jump off bed
You jump on the pile of pillows as they cushion your fall to the floor.

Bedroom
The room where the human resides for most of her time during the school year. 

The way to leave the room is to the north. It's time to explore.

On the Desk is Laptop.

You can also see Pillows here.

* * *

>take pillows
you take them.

>take pillow
(Pillows)
you take them.

* * *

What Rocky Does When No One's Around
An Interactive Fiction by Emily Seifert
Release 1 / Serial number 251008 / Inform 7 v10.1.2 / D

Bedroom (in the Bed)
The room where the human resides for most of her time during the school year. It's cozy. A galaxy themed aesthetic fills the bedsheets on the bed in which you and your fellow plushies lay on top of. The human is gone until 3pm, including her roommates. 

The way to leave the room is to the north. It's time to explore.

>take pillows
(Now the pillows)
You can't reach Now the pillows from here.

>hop
You jump on the spot.

* * *

>take pillows
(Now the pillows)
You can't reach Now the pillows from here.

>look bed
You are on the bed, there are other plushies on the pillows behind you.

In the Bed is Pillows.

>look pillows
(Now pillows)
You see nothing special about Now pillows.

* * *

What Rocky Does When No One's Around
An Interactive Fiction by Emily Seifert
Release 1 / Serial number 251008 / Inform 7 v10.1.2 / D

Bedroom (in the Bed)
The room where the human resides for most of her time during the school year. It's cozy. A galaxy themed aesthetic fills the bedsheets on the bed in which you and your fellow plushies lay on top of. The human is gone until 3pm, including her roommates. 

The way to leave the room is to the north. It's time to explore.

>talk pluhiws
You can't see any such thing.

>talk plushies
As you attempt to ask the plushies to move, the white branded dog on top of the hoard interjects 
 "Hey!" he says, "We aren't gonna move just because you asked us!!"

 "Yeah! The foxes and smaller rabbits say, "We only follow what each other here on the pillows say! 

 It looks as if you might need to find a more reasonable plushie.

>talk rabbit
"You appraoch the brown-grey rabbit instead. 
 Hi Rocky! What do you need?" the rabbit says.

 You politely ask the rabbit for him and the others plushies to leave the pillows so you can use them.

 "Oh! Okay! It would probably be a good change of scenery." it says as it convinces the others to leave. "Good luck with whatever you're doing! :)"

* * *

>take pillows
Now that your friends are no longer on the pillows, you take them.

>take plushies
That's fixed in place.

* * *

What Rocky Does When No One's Around
An Interactive Fiction by Emily Seifert
Release 1 / Serial number 251008 / Inform 7 v10.1.2 / D

Bedroom (in the Bed)
The room where the human resides for most of her time during the school year. It's cozy. A galaxy themed aesthetic fills the bedsheets on the bed in which you and your fellow plushies lay on top of. The human is gone until 3pm, including her roommates. 

The way to leave the room is to the north. It's time to explore.

>talk plushies
As you attempt to ask the plushies to move, the white branded dog on top of the hoard interjects 
 "Hey!" he says, "We aren't gonna move just because you asked us!!"

 "Yeah! The foxes and smaller rabbits say, "We only follow what each other here on the pillows say! 

 It looks as if you might need to find a more reasonable plushie.

>leave
You get out of the Bed.

Bedroom
The room where the human resides for most of her time during the school year. 

The way to leave the room is to the north. It's time to explore.

On the Desk is Laptop.

You can also see Rabbit here.

>desk
That's not a verb I recognise.

* * *

>look desk
It's a bit messy, but yet organized. The laptop is the only thing that peaks your curiosity.

On the Desk is Laptop.

>look laptop
You see nothing special about Laptop.

* * *

>talk plushies
As you attempt to ask the plushies to move, the white branded dog on top of the hoard interjects 
 "Hey!" he says, "We aren't gonna move just because you asked us!!"

 "Yeah! The foxes and smaller rabbits say, "We only follow what each other here on the pillows say! 

 It looks as if you might need to find a more reasonable plushie.

>take plushies
Force is not the best way to solve your issues.

>talk rabbit
"You appraoch the brown-grey rabbit instead. 
 Hi Rocky! What do you need?" the rabbit says.

 You politely ask the rabbit for him and the others plushies to leave the pillows so you can use them.

 "Oh! Okay! It would probably be a good change of scenery." it says as it convinces the others to leave. "Good luck with whatever you're doing! :)"

* * *

>n
(first opening Bedroom door)

hallway
 Yup, its a hallway. There's a beam in the middle of the space. Someone could run into that!  You can go west to the area of Skull Kid's room or east to where the living room and Monster Kid's room are.

>e
Path 2
Monster Kid's room is south. The living room is north of here.

>n
Living room
It's a wide open space that includes a couch and even at tv! For some reason, there is a ballpit here. The connected kitchen is west of here.

On Coffee table is Tv remote.

>w
Kitchen
It's connected to the wide open space that is living room. The sink has apparently been leaking since you moved in. Getting a snack sounds good right about now.

You can see Fridge (in which is Snacks) and Stove here.

* * *

>take snacls
You can't see any such thing.

>take snacks
Taken.

>open fridge
It isn't something you can open.

* * *

>take pillows
Now that your friends are no longer on the pillows, you take them.

>drop
(Pillows)
Dropped.

>take pillows
you take them.

>throw pillows
one by one you toss the pillows over the edge of the bed. They seemed to have made quite the pile to break your stuffed fall.

>leave
You jump on the pile of pillows as they cushion your fall to the floor.

Bedroom
The room where the human resides for most of her time during the school year. 

The way to leave the room is to the north. It's time to explore.

On the Desk is Laptop.

You can also see Pillows here.

>take pillow
You can't see any such thing.

>take pillows
you take them.

* * *

>take pillows
Now that your friends are no longer on the pillows, you take them.

>drop pillows
Dropped.

>take pillows
Now that your friends are no longer on the pillows, you take them.

* * *

>talk plushies
As you attempt to ask the plushies to move, the white branded dog on top of the hoard interjects 
 "Hey!" he says, "We aren't gonna move just because you asked us!!"

 "Yeah! The foxes and smaller rabbits say, "We only follow what each other here on the pillows say! 

 It looks as if you might need to find a more reasonable plushie.

>talk to plushies
As you attempt to ask the plushies to move, the white branded dog on top of the hoard interjects 
 "Hey!" he says, "We aren't gonna move just because you asked us!!"

 "Yeah! The foxes and smaller rabbits say, "We only follow what eachother here on the pillows say! 

 It looks as if you might need to find a more reasonable plushie.

>talk to rabbit
"Hi Rocky! What do you need?" the rabbit says.
 You politely ask the rabbit and the others plushies to leave the pillows so you can use them.

 "Oh! Okay! Good luck with whatever you're doing! :)"

* * *

What Rocky Does When No One's Around
An Interactive Fiction by Emily Seifert
Release 1 / Serial number 251008 / Inform 7 v10.1.2 / D

Bedroom (in the Bed)
The room where the human resides for most of her time during the school year. It's cozy. A galaxy themed aesthetic fills the bedsheets on the bed in which you and your fellow plushies lay on top of. The human is gone until 3pm, including her roommates. 

The way to leave the room is to the north. It's time to explore.

>talk rabbit
"You appraoch the brown-grey rabbit instead. 
 Hi Rocky! What do you need?" the rabbit says.

 You politely ask the rabbit for him and the others plushies to leave the pillows so you can use them.

 "Oh! Okay! It would probably be a good change of scenery." it says as it convinces the others to leave. "Good luck with whatever you're doing! :)"

>look plushies
There's a variety of little plush toys placed gently on each pillow. They range from two tiny foxes, a white dog with a red target for an eye, and 4 bunnies of different shapes and sizes. The thin brown and grey rabbit sitting in front of the first pillow seems the most reasonable to talk to.

>talk to rabbit
"Hi Rocky! What do you need?" the rabbit says.
 You politely ask the rabbit and the others plushies to leave the pillows so you can use them.

 "Oh! Okay! Good luck with whatever you're doing! :)"

* * *

>talk rabbit
"You appraoch the brown-grey rabbit instead. 
 Hi Rocky! What do you need?" the rabbit says.

 You politely ask the rabbit for him and the others plushies to leave the pillows so you can use them.

 "Oh! Okay! It would probably be a good change of scenery." it says as it convinces the others to leave. "Good luck with whatever you're doing! :)"

>take pillow
Now that your friends are no longer on the pillows, you take them.

>throw pillow
one by one you toss the pillows over the edge of the bed. They seemed to have made quite the pile to break your stuffed fall.

>leave
You jump on the pile of pillows as they cushion your fall to the floor.

Bedroom
The room where the human resides for most of her time during the school year. 

The way to leave the room is to the north. It's time to explore.

On the Desk is Laptop.

You can also see Pillows here.

>open door
You're just too short to reach the doorknob. Maybe there's something you can stand on.

>n
(first opening Bedroom door)
You're just too short to reach the doorknob. Maybe there's something you can stand on.

>n
(first opening Bedroom door)
You're just too short to reach the doorknob. Maybe there's something you can stand on.

>take pillow
you take them.

>open door
You're just too short to reach the doorknob. Maybe there's something you can stand on.

>use pillow on door
I only understood you as far as wanting to use Pillows.

* * *

>take pillows
Now that your friends are no longer on the pillows, you take them.

>jump off bead
I only understood you as far as wanting to jump.

>jump off bed
You jump on the pile of pillows as they cushion your fall to the floor.

Bedroom
The room where the human resides for most of her time during the school year. 

The way to leave the room is to the north. It's time to explore.

On the Desk is Laptop.

>take pillows
you take them.

* * *

>n
(first opening Bedroom door)

hallway
 Yup, its a hallway. There's a beam in the middle of the space. Someone could run into that!  You can go west to the area of Skull Kid's room or east to where the living room and Monster Kid's room are.

>w
Path 1
Skull Kid's room is to the south.

>s
Skull kid's door

>s
You can't go that way.

* * *

>take pillows
Now that your friends are no longer on the pillows, you take them.

>jump off bed
You jump on the pile of pillows as they cushion your fall to the floor.

Bedroom
The room where the human resides for most of her time during the school year. 

The way to leave the room is to the north. It's time to explore.

On the Desk is Laptop.

>sit chait
You can't see any such thing.

* * *

>n
(first getting off Chair)

Bedroom
The room where the human resides for most of her time during the school year. 

The way to leave the room is to the north. It's time to explore.

On the Desk is Laptop.

(first opening Bedroom door)
It seems to be locked.

* * *

>e
Path 2
Monster Kid's room is south. The living room is north of here.

>s
Monster Kid's Room
It's pretty bare bones. There's a few scary looking monster figures on the dresser and the windowsill, fake plants are scattered around as well.  You don't know why you walked in here...

>sit spinny chair
You can't see any such thing.

* * *

>take pillows
Now that your friends are no longer on the pillows, you take them.

>throw
(Pillows)
one by one you toss the pillows over the edge of the bed. They seemed to have made quite the pile to break your stuffed fall.

>leave
(the Bed)
You jump on the pile of pillows as they cushion your fall to the floor.

Bedroom
The room where the human resides for most of her time during the school year. 

The way to leave the room is to the north. It's time to explore.

On the Desk is Laptop.

You can also see Pillows here.

>take pillow
That's hardly portable.

>open door
It seems to be locked.

>unlock door
You place the pillow on the side of the door, and stand on top of it. You're able to reach the doorknob and open the door to the hallway.

* * *

>take pillow
That's hardly portable.

>take pillows
you take them.

* * *

>use pillows on door
I only understood you as far as wanting to use Pillows.

* * *

>leave
(the Bed)
You jump on the pile of pillows as they cushion your fall to the floor.

Bedroom
The room where the human resides for most of her time during the school year. 

The way to leave the room is to the north. It's time to explore.

On the Desk is Laptop.

You can also see Pillows here.

>take pillows
you take them.

>n
(first opening Bedroom door)
It seems to be locked.

>use pillows on door
I only understood you as far as wanting to use Pillows.

>unlock door
You place the pillow on the side of the door, and stand on top of it. You're able to reach the doorknob and open the door to the hallway.

* * *

>take pillows
you take them.

>open door
You place the pillow on the side of the door, and stand on top of it. You're able to reach the doorknob and open the door to the hallway.

>n
(first opening Bedroom door)
You place the pillow on the side of the door, and stand on top of it. You're able to reach the doorknob and open the door to the hallway.

>n
(first opening Bedroom door)
You place the pillow on the side of the door, and stand on top of it. You're able to reach the doorknob and open the door to the hallway.

>leave
You jump on the pile of pillows as they cushion your fall to the floor.

Bedroom
The room where the human resides for most of her time during the school year. 

The way to leave the room is to the north. It's time to explore.

On the Desk is Laptop.

* * *

>open door
You place the pillow on the side of the door, and stand on top of it. You're able to reach the doorknob and open the door to the hallway.

* * *

>n
(first opening Bedroom door)
You place the pillow on the side of the door, and stand on top of it. You're able to reach the doorknob and open the door to the hallway.

I beg your pardon?

* * *

>take pillow
(Pillows)
you take them.

>open door
You're just too short to reach the doorknob. Maybe there's something you can stand on.

>use pillows on door
I only understood you as far as wanting to use Pillows.

>use pillow
(Pillows)

>door
That's not a verb I recognise.

* * *

>take pillows
Now that your friends are no longer on the pillows, you take them.

>throw pilllows
You can't see any such thing.

>throw
(Pillows)
one by one you toss the pillows over the edge of the bed. They seemed to have made quite the pile to break your stuffed fall.

* * *

>leave
(the Bed)
You jump on the pile of pillows as they cushion your fall to the floor.

Bedroom
The room where the human resides for most of her time during the school year. 

The way to leave the room is to the north. It's time to explore.

On the Desk is Laptop.

You can also see Pillows here.

>door
That's not a verb I recognise.

>n
(first opening Bedroom door)
It seems to be locked.

>take pillow
That's hardly portable.

* * *

>n
(first opening Bedroom door)
It seems to be locked.

>open door
It seems to be locked.

* * *

>take pillows
Now that your friends are no longer on the pillows, you take them.

>throw pilloes
You can't see any such thing.

>throw pilloes
You can't see any such thing.

>throw pillows
one by one you toss the pillows over the edge of the bed. They seemed to have made quite the pile to break your stuffed fall.

* * *

>e
Path 2
Monster Kid's room is south. The living room is north of here.

>n
Living room
It's a wide open space that includes a couch and even at tv! For some reason, there is a ballpit here. The connected kitchen is west of here, and the halls are to the south.

On Coffee table is Tv remote.

>use ball pit
You can't see any such thing.

>use ballpit
You hop in the ballpit. It's full of multicolored balls. You have the uge to play inside.

>play in ballpit
You mess around in the ballpit, the texture feels nice against your fur. You even attempt to throw some in the hoop. It's a blast!

>get out of ballpit
You hop out of the ball pit. Man! That was fun! Time to do something else.

>n
You can't go that way.

>w
Kitchen
It's connected to the wide open space that is living room. The sink has apparently been leaking since you moved in. Getting a snack sounds good right about now. The living room is to the east.

You can see Fridge (closed) and Stove here.

>open fridge
You somehow manage to get the fridge open. It's chilly, but an array of choices for you to snack on speak to your nose. Time to get a snack.

You open Fridge, revealing Snacks.

>take snack
you take whatever is closest to you in the fridge. Whatever it is, it looks yummy.

>eat snacks
you eat what appears to be an apple, some cheese, and some bread (gluten free). You hope the human and her roommates will forgive you for your actions today. In your defense, they were delicious.

    *** It's 3pm! The human is home from school!
You stop whatever you were doing and go limp. 

 "Huh. Looks like you had a fun day." she says as she picks you up and places you back on the bed. She gently pets you're head before going back to work.

 Today was a good day! ***

Would you like to RESTART, RESTORE a saved game, QUIT or UNDO the last command?

* * *

>e
Path 2
Monster Kid's room is south. The living room is north of here.

>s
Monster Kid's Room
It's pretty bare bones. There's a few scary looking monster figures on the dresser and the windowsill, fake plants are scattered around as well. The odd looking spinny chair does catch you eye though, you don't know why you walked in here...

>sit spinny chair
You hoist your body onto the seat and get on the chair. You reposition yourself so you're facing the desk.

Bedroom (on Chair)
The room where the human resides for most of her time during the school year. 

The way to leave the room is to the north. It's time to explore.

On the Desk is Laptop.

* * *

>throw pillows
one by one you toss the pillows over the edge of the bed. They seemed to have made quite the pile to break your stuffed fall.

>eat pillows
That's plainly inedible.

>jump off bed
You jump on the pile of pillows as they cushion your fall to the floor.

Bedroom
The room where the human resides for most of her time during the school year. 

The way to leave the room is to the north. It's time to explore.

On the Desk is Laptop.

You can also see Pillows here.

* * *

>s
Skull Kid's Room
 It's full of skull and meme memorabilia. Whatever a "meme" is you don't know.  There's a few of your stuffed friends on the bed in here. The hallway is north of here.

You can see Dog Boy here.

>talk dog boy
OH HAI ROCKY! 

 Did you know that there's many hidden treasures within sea?! Someday when I get bigger, I'll be on a ship and go find them! I'll be the first puppy to find treasure! I hope they have gold.. MAYBE golden coins! With the skulls on them! Did you know that crabs live on the sea floor? They're quite mean though.. They pinch! I miss the beach and being able to smell the salty water. Do you think my human will bring me back there? I hope so! I really hope! :D

  (this goes on for some time)

* * *

>throw pillows
one by one you toss the pillows over the edge of the bed. They seemed to have made quite the pile to break your stuffed fall.

>jump off bed
You jump on the pile of pillows as they cushion your fall to the floor.

Bedroom
The room where the human resides for most of her time during the school year. 

The way to leave the room is to the north. It's time to explore.

You can see Pillows here.

* * *

>look chair
It's a wooden chair with a cushioned seat and backing. You're just tall enough to climb on top.

>sit chiar
You can't see any such thing.

>sit on chair
You get onto Chair.

* * *

>use laptop
You need to be able use to reach the desk first. Maybe use the chair in front of the desk.

* * *

>sit desk chiar
I only understood you as far as wanting to sit the Desk.

>sit desk chair
I only understood you as far as wanting to sit the Desk.

* * *

>jump off bed
You jump on the pile of pillows as they cushion your fall to the floor.

Bedroom
The room where the human resides for most of her time during the school year. 

The way to leave the room is to the north. It's time to explore.

You can see Pillows here.

>sit on chair
You get onto Chair.

>sitting chair
That's not a verb I recognise.

>use laptop
You open up the laptop and turn it on. It is just a bit slow like the human says it is, but it's still perfectly functional.
 You find yourself flumbing on here for hours.

 You don't know how it happened, but you end up watching an hour long deep dive video about a long gone childrens game. Time was lost to you.

>n
(first getting off Chair)

Bedroom
The room where the human resides for most of her time during the school year. 

The way to leave the room is to the north. It's time to explore.

On the Desk is Laptop.

You can also see Pillows here.

(first opening Bedroom door)
It seems to be locked.

>take pillows
you take them.

* * *

>unlock door
You place the pillow on the side of the door, and stand on top of it. You're able to reach the doorknob and open the door to the hallway.

>e
You can't go that way.

>n
(first opening Bedroom door)

hallway
 Yup, its a hallway. There's a beam in the middle of the space. Someone could run into that!  You can go west to the area of Skull Kid's room or east to where the living room and Monster Kid's room are.

* * *

>e
Path 2
Monster Kid's room is south. The living room is north of here.

>s
Monster Kid's Room
It's pretty bare bones. There's a few scary looking monster figures on the dresser and the windowsill, fake plants are scattered around as well. The odd looking spinny chair does catch you eye though, you don't know why you walked in here... The halls are north of here.

* * *

>jump off bed
You jump on the pile of pillows as they cushion your fall to the floor.

Bedroom
The room where the human resides for most of her time during the school year. 

The way to leave the room is to the north. It's time to explore.

You can see Pillows here.

>take pillows
you take them.

* * *

>n
(first opening Bedroom door)
It seems to be locked.

>unlock door
You place the pillow on the side of the door, and stand on top of it. You're able to reach the doorknob and open the door to the hallway.

* * *

>get on skull kids bed
You can't see any such thing.

>get on bed
You manage to hop ontop of Skull Kid's bed. It feels more comfortable to take a nap on. Maybe it's because Skull Kid is more prone to napping than your human. You want to try it now.

You get into Skull Kid's Bed.

>nap
(Pillows)
You feel your plastic eyes get heavy and you fall asleep. Dreaming stuffed platypus dreams.

* * *

>take pillows
you take them.

>open door
It seems to be locked.

* * *

>s
Skull Kid's Room
 It's full of skull and meme memorabilia. Whatever a "meme" is you don't know.  There's a few of your stuffed friends on the bed in here. The hallway is north of here.

You can see Dog Boy here.

>get on bed
You manage to hop ontop of Skull Kid's bed. It feels more comfortable to take a nap on. Maybe it's because Skull Kid is more prone to napping than your human. You want to try it now.

You get into Skull Kid's Bed.

>nap
(Pillows)
You feel your plastic eyes get heavy and you fall asleep. Dreaming stuffed platypus dreams.

    *** It's 3pm! The human is home from school!
You stop whatever you were doing and go limp. 

 "Huh. Looks like you had a fun day." she says as she picks you up and places you back on the bed. She gently pets you're head before going back to work.

 Today was a good day! ***

Would you like to RESTART, RESTORE a saved game, QUIT or UNDO the last command?

>restart
What Rocky Does When No One's Around
An Interactive Fiction by Emily Seifert
Release 1 / Serial number 251007 / Inform 7 v10.1.2 / D

Bedroom (in the Bed)
The room where the human resides for most of her time during the school year. It's cozy. A galaxy themed aesthetic fills the bedsheets on the bed in which you and your fellow plushies lay on top of. The human is gone until 3pm, including her roommates. 

The way to leave the room is to the north. It's time to explore.

On the Desk is Laptop.

In the Bed you can see Pillows (on which is Plushies) and Rabbit.

>talk rabbit
"You appraoch the brown-grey rabbit instead. 
 Hi Rocky! What do you need?" the rabbit says.

 You politely ask the rabbit for him and the others plushies to leave the pillows so you can use them.

 "Oh! Okay! It would probably be a good change of scenery." it says as it convinces the others to leave. "Good luck with whatever you're doing! :)"

* * *

>jump off bed
You jump on the pile of pillows as they cushion your fall to the floor.

Bedroom
The room where the human resides for most of her time during the school year. 

The way to leave the room is to the north. It's time to explore.

On the Desk is Laptop.

You can also see Pillows here.

>take pillow
That's hardly portable.

* * *

>n
Living room
It's a wide open space that includes a couch and even at tv! For some reason, there is a ballpit here. The connected kitchen is west of here, and the halls are to the south.

On Coffee table is Tv remote.

>use ballpit
You hop in the ballpit. It's full of multicolored balls. You have the uge to play inside.

* * *

>take pillows
you take them.

>sit on chair
You get onto Chair.

>use laptop
You open up the laptop and turn it on. It is just a bit slow like the human says it is, but it's still perfectly functional.
 You find yourself flumbing on here for hours.

 You don't know how it happened, but you end up watching an hour long deep dive video about a long gone childrens game. Time was lost to you.

>n
(first getting off Chair)
You jump on the pile of pillows as they cushion your fall to the floor.

Bedroom
The room where the human resides for most of her time during the school year. 

The way to leave the room is to the north. It's time to explore.

On the Desk is Laptop.

(first opening Bedroom door)
It seems to be locked.

>unlock door
You place the pillow on the side of the door, and stand on top of it. You're able to reach the doorknob and open the door to the hallway.

* * *

>n
(first opening Bedroom door)

hallway
 Yup, its a hallway. There's a beam in the middle of the space. Someone could run into that!  You can go west to the area of Skull Kid's room or east to where the living room and Monster Kid's room are.

>s
Bedroom
The room where the human resides for most of her time during the school year. 

The way to leave the room is to the north. It's time to explore.

On the Desk is Laptop.

>n
hallway
 You can go west to the area of Skull Kid's room or east to where the living room and Monster Kid's room are.

>e
Path 2
Monster Kid's room is south. The living room is north of here.

* * *

I beg your pardon?

>sit on spinny chair
You can't see any such thing.

>n
(first getting off Chair)
You jump on the pile of pillows as they cushion your fall to the floor.

Bedroom
The room where the human resides for most of her time during the school year. 

The way to leave the room is to the north. It's time to explore.

On the Desk is Laptop.

hallway
 You can go west to the area of Skull Kid's room or east to where the living room and Monster Kid's room are.

>e
Path 2
Monster Kid's room is south. The living room is north of here.

* * *

>take remote
You can't see any such thing.

>take tv remote
You can't see any such thing.

>s
(first getting off Chair)
You jump on the pile of pillows as they cushion your fall to the floor.

Bedroom
The room where the human resides for most of her time during the school year. 

The way to leave the room is to the north. It's time to explore.

On the Desk is Laptop.

You can't go that way.

>n
hallway
 You can go west to the area of Skull Kid's room or east to where the living room and Monster Kid's room are.

* * *

>e
Path 2
Monster Kid's room is south. The living room is north of here.

>s
Monster Kid's Room
The odd looking spinny chair does catch you eye though, you don't know why you walked in here...

* * *

>spin
(Pillows)
Why would you need to spin right now?

>drop pillows
Dropped.

>sit spinny chiar
You can't see any such thing.

>sit spinny chair
You can't see any such thing.

>s
(first getting off Chair)
You jump on the pile of pillows as they cushion your fall to the floor.

Bedroom
The room where the human resides for most of her time during the school year. 

The way to leave the room is to the north. It's time to explore.

On Chair is Pillows.

On the Desk is Laptop.

You can't go that way.

>sit chiar
You can't see any such thing.

* * *

>use laptop
You open up the laptop and turn it on. It is just a bit slow like the human says it is, but it's still perfectly functional.
 You find yourself flumbing on here for hours.

 You don't know how it happened, but you end up watching an hour long deep dive video about a long gone childrens game. Time was lost to you.

>play
What do you want to play?

>play ballpit
You can't see any such thing.

* * *

>s
Monster Kid's Room
It's pretty bare bones. There's a few scary looking monster figures on the dresser and the windowsill, fake plants are scattered around as well. The odd looking spinny chair does catch you eye though, you don't know why you walked in here...

>sit spinny chair
Bedroom (on Chair)
The room where the human resides for most of her time during the school year. 

The way to leave the room is to the north. It's time to explore.

On the Desk is Laptop.

>n
(first getting off Chair)
You jump on the pile of pillows as they cushion your fall to the floor.

Bedroom
The room where the human resides for most of her time during the school year. 

The way to leave the room is to the north. It's time to explore.

On the Desk is Laptop.

hallway
 You can go west to the area of Skull Kid's room or east to where the living room and Monster Kid's room are.

* * *

>n
Living room
It's a wide open space that includes a couch and even at tv! For some reason, there is a ballpit here. The connected kitchen is west of here.

On Coffee table is Tv remote.

>sit couch
Bedroom (on Chair)
The room where the human resides for most of her time during the school year. 

The way to leave the room is to the north. It's time to explore.

On the Desk is Laptop.

>n
(first getting off Chair)
You jump on the pile of pillows as they cushion your fall to the floor.

Bedroom
The room where the human resides for most of her time during the school year. 

The way to leave the room is to the north. It's time to explore.

On the Desk is Laptop.

hallway
 You can go west to the area of Skull Kid's room or east to where the living room and Monster Kid's room are.

* * *

>n
Living room
It's a wide open space that includes a couch and even at tv! For some reason, there is a ballpit here. The connected kitchen is west of here.

On Coffee table is Tv remote.

>use ballpit
You hop in the ballpit. It's full of multicolored balls. You have the uge to play inside.

Living room (in Ballpit)
It's a wide open space that includes a couch and even at tv! For some reason, there is a ballpit here. The connected kitchen is west of here.

On Coffee table is Tv remote.

>play in ballpit
You mess around in the ballpit, the texture feels nice against your fur. You even attempt to throw some in the hoop. It's a blast!

* * *

>n
(first opening Bedroom door)

hallway
 Yup, its a hallway. There's a beam in the middle of the space. Someone could run into that!  You can go west to the area of Skull Kid's room or east to where the living room and Monster Kid's room are.

>e
Path 2
Monster Kid's room is south. The living room is north of here. Hallway is to the west.

>n
Living room
It's a wide open space that includes a couch and even at tv! For some reason, there is a ballpit here. The connected kitchen is west of here, and the halls are to the south.

On Coffee table is Tv remote.

>s
Path 2
Monster Kid's room is south. The living room is north of here.

>n
Living room
 The connected kitchen is west of here, and the halls are to the south.

On Coffee table is Tv remote.

>w
Kitchen
It's connected to the wide open space that is living room. The sink has apparently been leaking since you moved in. Getting a snack sounds good right about now. The living room is to the east.

You can see Fridge (closed) and Stove here.

>open fridge
It isn't something you can open.

* * *

>n
Living room
It's a wide open space that includes a couch and even at tv! For some reason, there is a ballpit here. The connected kitchen is west of here, and the halls are to the south.

On Coffee table is Tv remote.

>sit couch
It's a lot easy to get onto then the chair. Not only that theres more room for you to stretch! This is awesome! There's a good view of the tv from here, just need to turn it on.

>take remote
You can't reach Tv remote from here.

>s
(first getting off Couch)
You can't reach into Bedroom.

You would have to get off Couch first.

>get off couch
You get off Couch.

Living room
 The connected kitchen is west of here, and the halls are to the south.

On Coffee table is Tv remote.

>s
Path 2
Monster Kid's room is south. The living room is north of here. Hallway is to the west.

>w
hallway
 You can go west to the area of Skull Kid's room or east to where the living room and Monster Kid's room are.

>n
You can't go that way.

>s
Bedroom
The room where the human resides for most of her time during the school year. 

The way to leave the room is to the north. It's time to explore.

>sit chair
You hoist your body onto the seat and get on the chair. You reposition yourself so you're facing the desk.

Bedroom (on Chair)
The room where the human resides for most of her time during the school year. 

The way to leave the room is to the north. It's time to explore.

>use laptop
You open up the laptop and turn it on. It is just a bit slow like the human says it is, but it's still perfectly functional.
 You find yourself fumbling on here for hours.

 You don't know how it happened, but you end up watching an hour long deep dive video about a long gone childrens game. Time was lost to you.

    *** It's 3pm! The human is home from school!
You stop whatever you were doing and go limp. 

 "Huh. Looks like you had a fun day." she says as she picks you up and places you back on the bed. She gently pets you're head before going back to work.

 Today was a good day! ***

Would you like to RESTART, RESTORE a saved game, QUIT or UNDO the last command?

>undo
Bedroom
[Previous turn undone.]

>get off chair
You get off Chair.

Bedroom
The room where the human resides for most of her time during the school year. 

The way to leave the room is to the north. It's time to explore.

>n
hallway
 You can go west to the area of Skull Kid's room or east to where the living room and Monster Kid's room are.

>w
Path 1
Skull Kid's room is to the south.  The Human's room, Monster Kid's room and the living room are east of here.

>s
Skull Kid's Room
 It's full of skull and meme memorabilia. Whatever a "meme" is you don't know.  There's a few of your stuffed friends on the bed in here. The hallway is north of here.

>get on skull kids bed
You can't see any such thing.

* * *

>get on bed
You manage to hop ontop of Skull Kid's bed. It feels more comfortable to take a nap on. Maybe it's because Skull Kid is more prone to napping than your human. You want to try it now.

You get into Skull Kid's Bed.

>nap skull kids bed
I only understood you as far as wanting to nap Skull Kid's Bed.

>nap
(Pillows)
You feel your plastic eyes get heavy and you fall asleep. Dreaming stuffed platypus dreams.

* * *

>use ballpit
You hop in the ballpit. It's full of multicolored balls. You have the uge to play inside.

>play ballpit
You mess around in the ballpit, the texture feels nice against your fur. You even attempt to throw some in the hoop. It's a blast!

* * *

>n
Living room
It's a wide open space that includes a couch and even at tv! For some reason, there is a ballpit here. The connected kitchen is west of here, and the halls are to the south.

On Coffee table is Tv remote.

>w
Kitchen
It's connected to the wide open space that is living room. The sink has apparently been leaking since you moved in. Getting a snack sounds good right about now. The living room is to the east.

You can see Fridge (closed) and Stove here.

>opem fridge
That's not a verb I recognise.

>open fridge
You somehow manage to get the fridge open. It's chilly, but an array of choices for you to snack on speak to your nose. Time to get a snack.

You open Fridge, revealing Snacks.

>take snacks
you take whatever is closest to you in the fridge. Whatever it is, it looks yummy.

>eat snacks
you eat what appears to be an apple, some cheese, and some bread (gluten free). You hope the human and her roommates will forgive you for your actions today. In your defence, they were delicious.

You eat Snacks. Not bad.

* * *

>open fridge
It isn't something you can open.

>e
Living room
It's a wide open space that includes a couch and even at tv! For some reason, there is a ballpit here. The connected kitchen is west of here.

On Coffee table is Tv remote.

>use ballpit
You hop in the ballpit. It's full of multicolored balls. You have the uge to play inside.

* * *

>e
Path 2
Monster Kid's room is south. The living room is north of here. Hallway is to the west.

>s
Monster Kid's Room
It's pretty bare bones. There's a few scary looking monster figures on the dresser and the windowsill, fake plants are scattered around as well. The odd looking spinny chair does catch you eye though, you don't know why you walked in here...

>sit spinny chair
You hoist your body onto the seat and get on the chair. You reposition yourself so you're facing the desk.

Bedroom (on Chair)
The room where the human resides for most of her time during the school year. 

The way to leave the room is to the north. It's time to explore.

On the Desk is Laptop.

 It appears this chair caught your attention, it's different the one the human has. With nothing better to do you climb onto this special chair. It spins slightly in your struggle to get up. You wonder what that could mean.

Monster Kid's Room (on Spinny Chair)
The odd looking spinny chair does catch you eye though, you don't know why you walked in here...

>spin
(Pillows)
You use your long plush tail to get the chair to move. It starts spinning. Faster and faster you feel the forces hit your plastic eyes. You've never felt more alive in your life. You keep the momentum up until you feel dizzy.

* * *

>s
Monster Kid's Room
It's pretty bare bones. There's a few scary looking monster figures on the dresser and the windowsill, fake plants are scattered around as well. The odd looking spinny chair does catch you eye though, you don't know why you walked in here...

>sit spinny chiat
I only understood you as far as wanting to sit Spinny Chair.

>sit spinny chair
You hoist your body onto the seat and get on the chair. You reposition yourself so you're facing the desk.

Bedroom (on Chair)
The room where the human resides for most of her time during the school year. 

The way to leave the room is to the north. It's time to explore.

On the Desk is Laptop.

 It appears this chair caught your attention, it's different the one the human has. With nothing better to do you climb onto this special chair. It spins slightly in your struggle to get up. You wonder what that could mean.

* * *

>n
hallway
 You can go west to the area of Skull Kid's room or east to where the living room and Monster Kid's room are.

>n
You can't go that way.

>w
Path 1
Skull Kid's room is to the south.

* * *

>n
(first getting off Skull Kid's Bed)
You can't reach into Bedroom.

You would have to get off Skull Kid's Bed first.

* * *

>n
hallway
 You can go west to the area of Skull Kid's room or east to where the living room and Monster Kid's room are.

>w
Path 1
Skull Kid's room is to the south.

* * *

>s
Skull Kid's Room
 It's full of skull and meme memorabilia. Whatever a "meme" is you don't know.  There's a few of your stuffed friends on the bed in here. The hallway is north of here.

You can see Dog Boy here.

>drop pillows
Dropped.

>get on bed
You get onto Skull Kid's Bed.

>leave
What do you want to leave?

* * *

>n
(first getting off Skull Kid's Bed)
You can't reach into Bedroom.

You would have to get off Skull Kid's Bed first.

>take pillows
You can't reach Pillows from here.

* * *

>s
Skull Kid's Room
 It's full of skull and meme memorabilia. Whatever a "meme" is you don't know.  There's a few of your stuffed friends on the bed in here. The hallway is north of here.

You can see Dog Boy here.

>get on bed
You manage to hop ontop of Skull Kid's bed. It feels more comfortable to take a nap on. Maybe it's because Skull Kid is more prone to napping than your human. You want to try it now.

Skull Kid's Room (in Skull Kid's Bed)
 There's a few of your stuffed friends on the bed in here. The hallway is north of here.

You can see Dog Boy here.

You get into Skull Kid's Bed.

>nap
(Pillows)
You feel your plastic eyes get heavy and you fall asleep. Dreaming stuffed platypus dreams.

* * *

>s
Skull Kid's Room
 It's full of skull and meme memorabilia. Whatever a "meme" is you don't know.  There's a few of your stuffed friends on the bed in here. The hallway is north of here.

You can see Dog Boy here.

>look bed
The bedding is black with white skulls, and has red sheets underneath. Of all the plushies that reside on top when Skull Kid is gone, Dog Boy, the rotund golden retreiver, is the one you talk to the most. This seems like a good place to take a nap.

>get on bed
You get into Skull Kid's Bed.

>off bed
That's not a verb I recognise.

>n
You would have to get out of Skull Kid's Bed first.

>s
You would have to get out of Skull Kid's Bed first.

>jump off bed
You can't reach into Bedroom.

>throw pillows
one by one you toss the pillows over the edge of the bed. They seemed to have made quite the pile to break your stuffed fall.

>jump off bed
You can't reach into Bedroom.

>leave
(Dog Boy)

>talk dog boy
OH HAI ROCKY! 

 Did you know that there's many hidden treasures within sea?! Someday when I get bigger, I'll be on a ship and go find them! I'll be the first puppy to find treasure! I hope they have gold.. MAYBE golden coins! With the skulls on them! Did you know that crabs live on the sea floor? They're quite mean though.. They pinch! I miss the beach and being able to smell the salty water. Do you think my human will bring me back there? I hope so! I really hope! :D

  (this goes on for some time)

>drop pillows
You can't see any such thing.

>take pillows
You can't see any such thing.

>get on skull kidds bed
You can't see any such thing.

>get on skull kids bed
You can't see any such thing.

>n
You would have to get out of Skull Kid's Bed first.

>jump off bed
You can't reach into Bedroom.

* * *

>s
Skull Kid's Room
 It's full of skull and meme memorabilia. Whatever a "meme" is you don't know.  There's a few of your stuffed friends on the bed in here. The hallway is north of here.

You can see Dog Boy here.

>talk dog boy
OH HAI ROCKY! 

 Did you know that there's many hidden treasures within sea?! Someday when I get bigger, I'll be on a ship and go find them! I'll be the first puppy to find treasure! I hope they have gold.. MAYBE golden coins! With the skulls on them! Did you know that crabs live on the sea floor? They're quite mean though.. They pinch! I miss the beach and being able to smell the salty water. Do you think skull kid will bring me back there? I hope so! I really hope! :D

  (this goes on for some time)

>look dog boy
It's the rotund little golden dog Skull Kid seems to be amored with. Dog Boy has carried similar personality traits as a result. At least he's fun to talk to.

* * *

>unlock door
You place the pillow on the side of the door, and stand on top of it. You're able to reach the doorknob and open the door to the hallway.

>w
You can't go that way.

>n
(first opening Bedroom door)

hallway
 Yup, its a hallway. There's a beam in the middle of the space. Someone could run into that!  You can go west to the area of Skull Kid's room or east to where the living room and Monster Kid's room are.

* * *

>get on bed
You get onto Skull Kid's Bed.

>nap
(Pillows)
there's no good place to nap right now.

* * *

>jump off bed
You jump on the pile of pillows as they cushion your fall to the floor.

Bedroom
The room where the human resides for most of her time during the school year. 

The way to leave the room is to the north. It's time to explore.

You can see Pillows here.

>take pillowws
You can't see any such thing.

>take pillows
you take them.

* * *

>talk dog boy
OH HAI ROCKY! 

 Did you know that there's many hidden treasures within sea?! Someday when I get bigger, I'll be on a ship and go find them! I'll be the first puppy to find treasure! I hope they have gold.. MAYBE golden coins! With the skulls on them! Did you know that crabs live on the sea floor? They're quite mean though.. They pinch! I miss the beach and being able to smell the salty water. Do you think my human will bring me back there? I hope so! I really hope! :D

  (this goes on for some time)

>n
Path 1
Skull Kid's room is to the south.

>e
hallway
 You can go west to the area of Skull Kid's room or east to where the living room and Monster Kid's room are.

>e
Path 2
Monster Kid's room is south. The living room is north of here.

* * *

>play in ballpit
You mess around in the ballpit, the texture feels nice against your fur. You even attempt to throw some in the hoop. It's a blast!

>n
You would have to get out of Ballpit first.

* * *

>leave
(Pillows)

* * *

>n
You would have to get out of Ballpit first.

* * *

>jump off bed
You jump on the pile of pillows as they cushion your fall to the floor.

Bedroom
The room where the human resides for most of her time during the school year. 

The way to leave the room is to the north. It's time to explore.

You can see Pillows here.

>unlock door
You're just too short to reach the doorknob. Maybe there's something you can stand on.

>take pillow
That's hardly portable.

* * *

>s
Bedroom
The room where the human resides for most of her time during the school year. 

The way to leave the room is to the north. It's time to explore.

On the Desk is Laptop.

>mn
That's not a verb I recognise.

>n
hallway
 You can go west to the area of Skull Kid's room or east to where the living room and Monster Kid's room are.

* * *

>jump off bed
You jump on the pile of pillows as they cushion your fall to the floor.

Bedroom
The room where the human resides for most of her time during the school year. 

The way to leave the room is to the north. It's time to explore.

You can see Pillows here.

>use chiar
You can't see any such thing.

* * *

>throw pillows
one by one you toss the pillows over the edge of the bed. They seemed to have made quite the pile to break your stuffed fall.

>leave
(the Bed)
You jump on the pile of pillows as they cushion your fall to the floor.

Bedroom
The room where the human resides for most of her time during the school year. 

The way to leave the room is to the north. It's time to explore.

On the Desk is Laptop.

You can also see Pillows here.

* * *

>throw pillows
one by one you toss the pillows over the edge of the bed. They seemed to have made quite the pile to break your stuffed fall.

>leave bed
You jump on the pile of pillows as they cushion your fall to the floor.

Bedroom
The room where the human resides for most of her time during the school year. 

The way to leave the room is to the north. It's time to explore.

On the Desk is Laptop.

You can also see Pillows here.

>take pilows
You can't see any such thing.

>take pillows
you take them.

* * *

>n
(first opening Bedroom door)
It seems to be locked.

>use pillow
You can't see any such thing.

>use pillow
You can't see any such thing.

* * *

>throw pillows
one by one you toss the pillows over the edge of the bed. They seemed to have made quite the pile to break your stuffed fall.

>take pillows
You can't reach Pillows from here.

>jump off bed
You jump on the pile of pillows as they cushion your fall to the floor.

Bedroom
The room where the human resides for most of her time during the school year. 

The way to leave the room is to the north. It's time to explore.

On the Desk is Laptop.

You can also see Pillows here.

* * *

>e
Path 2
Monster Kid's room is south. The living room is north of here.

>w
hallway
 You can go west to the area of Skull Kid's room or east to where the living room and Monster Kid's room are.

>w
Path 1
Skull Kid's room is to the south.

* * *

>take pillows
Now that your friends are no longer on the pillows, you take them.

>throw pillwos
You can't see any such thing.

>throw pillows
one by one you toss the pillows over the edge of the bed. They seemed to have made quite the pile to break your stuffed fall.

* * *

>s
Skull Kid's Room
 It's full of skull and meme memorabilia. Whatever a "meme" is you don't know.  There's a few of your stuffed friends on the bed in here. The hallway is north of here.

You can see Dog Boy here.

>n
Path 1
Skull Kid's room is to the south.

>w
You can't go that way.

>e
hallway
 You can go west to the area of Skull Kid's room or east to where the living room and Monster Kid's room are.

* * *

>s
Monster Kid's Room
It's pretty bare bones. There's a few scary looking monster figures on the dresser and the windowsill, fake plants are scattered around as well. The odd looking spinny chair does catch you eye though, you don't know why you walked in here... The halls are north of here.

>n
Path 2
Monster Kid's room is south. The living room is north of here.

>n
Living room
It's a wide open space that includes a couch and even at tv! For some reason, there is a ballpit here. The connected kitchen is west of here, and the halls are to the south.

On Coffee table is Tv remote.

>n
You can't go that way.

* * *

>take pillows
Now that your friends are no longer on the pillows, you take them.

>thrwo
That's not a verb I recognise.

>throw
(Pillows)
one by one you toss the pillows over the edge of the bed. They seemed to have made quite the pile to break your stuffed fall.

* * *

>e
Path 2
Monster Kid's room is south. The living room is north of here.

>n
Living room
It's a wide open space that includes a couch and even at tv! For some reason, there is a ballpit here.

On Coffee table is Tv remote.

>w
Kitchen
It's connected to the wide open space that is living room. The sink has apparently been leaking since you moved in. Getting a snack sounds good right about now.

You can see Fridge (empty) and Stove here.

>use stove
You'd burn if you use that.

>look fridge
 It's the cold place where the food is stored! There's a lot of options between the 3 of humans.

* * *

>take pillows
Now that your friends are no longer on the pillows, you take them.

* * *

>s
Skull Kid's Room
 It's full of skull and meme memorabilia. Whatever a "meme" is you don't know.  There's a few of your stuffed friends on the bed in here. The hallway is north of here.

You can see Dog Boy here.

>get on skull kids bed
You can't see any such thing.

>get on Skull Kids bed
You can't see any such thing.

>get on bed
You get into Skull Kid's Bed.

>nap
(Pillows)
You feel your plastic eyes get heavy and you fall asleep. Dreaming stuffed platypus dreams.

* * *

>talk rabbit
"You appraoch the brown-grey rabbit instead. 
 Hi Rocky! What do you need?" the rabbit says.

 You politely ask the rabbit for him and the others plushies to leave the pillows so you can use them.

 "Oh! Okay! It would probably be a good change of scenery." it says as it convinces the others to leave. "Good luck with whatever you're doing! :)"

>talk to rabbit
"You appraoch the brown-grey rabbit instead. 
 Hi Rocky! What do you need?" the rabbit says.
 You politely ask the rabbit for him and the others plushies to leave the pillows so you can use them.

 "Oh! Okay! It would probably be a good change of scenery" it says as it convinces the others to leave. "Good luck with whatever you're doing! :)"

* * *

>talk rabbit
"You appraoch the brown-grey rabbit instead. 
 Hi Rocky! What do you need?" the rabbit says.

 You politely ask the rabbit for him and the others plushies to leave the pillows so you can use them.

 "Oh! Okay! It would probably be a good change of scenery." it says as it convinces the others to leave. "Good luck with whatever you're doing! :)"

>throw pillows
(first taking Pillows)
Now that your friends are no longer on the pillows, you take them.

one by one you toss the pillows over the edge of the bed. They seemed to have made quite the pile to break your stuffed fall.

>jumo off bed
That's not a verb I recognise.

>jump off bed
You jump on the pile of pillows as they cushion your fall to the floor.

Bedroom
The room where the human resides for most of her time during the school year. 

The way to leave the room is to the north. It's time to explore.

>take pillows
you take them.

* * *

>n
(first opening Bedroom door)

hallway
 Yup, its a hallway. There's a beam in the middle of the space. Someone could run into that!  You can go west to the area of Skull Kid's room or east to where the living room and Monster Kid's room are.

>w
Path 1
Skull Kid's room is to the south.  The Human's room, Monster Kid's room and the living room are east of here.

* * *

>s
Skull Kid's Room
 It's full of skull and meme memorabilia. Whatever a "meme" is you don't know.  There's a few of your stuffed friends on the bed in here. The hallway is north of here.

>get on bed
You manage to hop ontop of Skull Kid's bed. It feels more comfortable to take a nap on. Maybe it's because Skull Kid is more prone to napping than your human. You want to try it now.

You get into Skull Kid's Bed.

* * *

>nap
(Pillows)
You feel your plastic eyes get heavy and you fall asleep. Dreaming stuffed platypus dreams.

    *** It's 3pm! The human is home from school!
You stop whatever you were doing and go limp. 

 "Huh. Looks like you had a fun day." she says as she picks you up and places you back on the bed. She gently pets you're head before going back to work.

 Today was a good day! ***

Would you like to RESTART, RESTORE a saved game, QUIT or UNDO the last command?

>get off bed
Please give one of the answers above.

Would you like to RESTART, RESTORE a saved game, QUIT or UNDO the last command?

>talk dog boy
Please give one of the answers above.

Would you like to RESTART, RESTORE a saved game, QUIT or UNDO the last command?

>n
Please give one of the answers above.

Would you like to RESTART, RESTORE a saved game, QUIT or UNDO the last command?

>leave
Please give one of the answers above.

Would you like to RESTART, RESTORE a saved game, QUIT or UNDO the last command?

>n
Please give one of the answers above.

Would you like to RESTART, RESTORE a saved game, QUIT or UNDO the last command?

>off bed
Please give one of the answers above.

Would you like to RESTART, RESTORE a saved game, QUIT or UNDO the last command?

>get out of skull kids bed
Please give one of the answers above.

Would you like to RESTART, RESTORE a saved game, QUIT or UNDO the last command?

>getting out skull kids bed
Please give one of the answers above.

Would you like to RESTART, RESTORE a saved game, QUIT or UNDO the last command?

>get out skull kids bed
Please give one of the answers above.

Would you like to RESTART, RESTORE a saved game, QUIT or UNDO the last command?

>leave skull kids bed
Please give one of the answers above.

Would you like to RESTART, RESTORE a saved game, QUIT or UNDO the last command?

* * *

>throw pillows
(first taking Pillows)
Now that your friends are no longer on the pillows, you take them.

one by one you toss the pillows over the edge of the bed. They seemed to have made quite the pile to break your stuffed fall.

>jump off bed
You jump on the pile of pillows as they cushion your fall to the floor.

Bedroom
The room where the human resides for most of her time during the school year. 

The way to leave the room is to the north. It's time to explore.

>jump off bed
Bedroom
The room where the human resides for most of her time during the school year. 

The way to leave the room is to the north. It's time to explore.

On the Desk is Laptop.

You can also see Pillows here.

>take pillows
you take them.

* * *

>jump off bed
You jump on the pile of pillows as they cushion your fall to the floor.

Bedroom
The room where the human resides for most of her time during the school year. 

The way to leave the room is to the north. It's time to explore.

>sit chair
You hoist your body onto the seat and get on the chair. You reposition yourself so you're facing the desk.

Bedroom (on Chair)
The room where the human resides for most of her time during the school year. 

The way to leave the room is to the north. It's time to explore.

>get off chair
You get off Chair.

Bedroom
The room where the human resides for most of her time during the school year. 

The way to leave the room is to the north. It's time to explore.

>n
(first opening Bedroom door)
It seems to be locked.

>take pillows
you take them.

* * *

>w
Path 1
Skull Kid's room is to the south.  The Human's room, Monster Kid's room and the living room are east of here.

>e
hallway
 You can go west to the area of Skull Kid's room or east to where the living room and Monster Kid's room are.

* * *

>s
Monster Kid's Room
It's pretty bare bones. There's a few scary looking monster figures on the dresser and the windowsill, fake plants are scattered around as well. The odd looking spinny chair does catch you eye though, you don't know why you walked in here... The halls are north of here.

>sit spinny chair
 It appears this chair caught your attention, it's different the one the human has. With nothing better to do you climb onto this special chair. It spins slightly in your struggle to get up. You wonder what that could mean.

Monster Kid's Room (on Spinny Chair)
The odd looking spinny chair does catch you eye though, you don't know why you walked in here... The halls are north of here.

>sit spinny chair
 It appears this chair caught your attention, it's different the one the human has. With nothing better to do you climb onto this special chair. It spins slightly in your struggle to get up. You wonder what that could mean.

Monster Kid's Room (on Spinny Chair)
The odd looking spinny chair does catch you eye though, you don't know why you walked in here... The halls are north of here.

>spin
(Spinny Chair)
You use your long plush tail to get the chair to move. It starts spinning. Faster and faster you feel the forces hit your plastic eyes. You've never felt more alive in your life. You keep the momentum up until you feel dizzy.

>spin
(Spinny Chair)
You use your long plush tail to get the chair to move. It starts spinning. Faster and faster you feel the forces hit your plastic eyes. You've never felt more alive in your life. You keep the momentum up until you feel dizzy.

>spin spinny chair
You use your long plush tail to get the chair to move. It starts spinning. Faster and faster you feel the forces hit your plastic eyes. You've never felt more alive in your life. You keep the momentum up until you feel dizzy.

* * *

>sit chair
You hoist your body onto the seat and get on the chair. You reposition yourself so you're facing the desk.

Bedroom (on Chair)
The room where the human resides for most of her time during the school year. 

The way to leave the room is to the north. It's time to explore.

>undo
Bedroom
[Previous turn undone.]

>showme
Bedroom - room
    yourself - person
    Pillows - supporter
    Bedroom door - locked door
    Bed - open container
        Plushies
        Rabbit
    Pillow
    Chair - supporter
    Desk - supporter
        Laptop

>actions
Actions listing on.

>sit chair
[sitting Chair]
[sitting Chair - succeeded]

>showme
Bedroom - room
    yourself - person
    Pillows - supporter
    Bedroom door - locked door
    Bed - open container
        Plushies
        Rabbit
    Pillow
    Chair - supporter
    Desk - supporter
        Laptop

* * *

>sit couch
It's a lot easy to get onto then the chair. Not only that theres more room for you to stretch! This is awesome! There's a good view of the tv from here, just need to turn it on.

>take remote
You grab the remote off the coffee table. You think this device is what turns on the tv.

>showme
Living room - room
    Ballpit - open container
    Couch - supporter
        yourself - person
            Tv remote
            Pillows - supporter
    Coffee table - supporter
    Tv

>take remote
You grab the remote off the coffee table. You think this device is what turns on the tv.

* * *

>showme
Living room - room
    Ballpit - open container
    Couch - supporter
        yourself - person
            Tv remote
            Pillows - supporter
    Coffee table - supporter
    Tv

>actions
Actions listing on.

>take remote
[taking Tv remote]
You grab the remote off the coffee table. You think this device is what turns on the tv.
[taking Tv remote - ended without result]

>i
[taking inventory]
You are carrying:
  Tv remote
  Pillows

[taking inventory - succeeded]

>turn on tv
(Tv remote)
[switching on Tv remote]
It isn't something you can switch.
[switching on Tv remote - failed the can't switch on unless switchable rule]

>turn on tv
(Tv remote)
[switching on Tv remote]
It isn't something you can switch.
[switching on Tv remote - failed the can't switch on unless switchable rule]

* * *

>unlock door
You place the pillow on the side of the door, and stand on top of it. You're able to reach the doorknob and open the door to the hallway.

* * *

>e
hallway
 You can go west to the area of Skull Kid's room or east to where the living room and Monster Kid's room are.

>w
Path 1
Skull Kid's room is to the south.  The Human's room, Monster Kid's room and the living room are east of here.

>w
You can't go that way.

* * *

>s
Monster Kid's Room
It's pretty bare bones. There's a few scary looking monster figures on the dresser and the windowsill, fake plants are scattered around as well. The odd looking spinny chair does catch you eye though, you don't know why you walked in here... The halls are north of here.

>sit spinny chair
 It appears this chair caught your attention, it's different the one the human has. With nothing better to do you climb onto this special chair. It spins slightly in your struggle to get up. You wonder what that could mean.

>spin spinny chair
You use your long plush tail to get the chair to move. It starts spinning. Faster and faster you feel the forces hit your plastic eyes. You've never felt more alive in your life. You keep the momentum up until you feel dizzy.

>get off chair
You get off Spinny Chair.

Monster Kid's Room
The odd looking spinny chair does catch you eye though, you don't know why you walked in here... The halls are north of here.

>n
Path 2
Monster Kid's room is south. The living room is north of here.

* * *

>sit couch
It's a lot easy to get onto then the chair. Not only that theres more room for you to stretch! This is awesome! There's a good view of the tv from here, just need to turn it on.

>take tv remote
You can't reach Tv remote from here.

>take remote
You can't reach Tv remote from here.

* * *

What Rocky Does When No One's Around
An Interactive Fiction by Emily Seifert
Release 1 / Serial number 251008 / Inform 7 v10.1.2 / D

Bedroom (in the Bed)
The room where the human resides for most of her time during the school year. It's cozy. A galaxy themed aesthetic fills the bedsheets on the bed in which you and your fellow plushies lay on top of. The human is gone until 3pm, including her roommates. 

The way to leave the room is to the north. It's time to explore.

>talk to rabbit
"You appraoch the brown-grey rabbit instead. 
 Hi Rocky! What do you need?" the rabbit says.

 You politely ask the rabbit for him and the others plushies to leave the pillows so you can use them.

 "Oh! Okay! It would probably be a good change of scenery" it says as it convinces the others to leave. "Good luck with whatever you're doing! :)"

* * *

What Rocky Does When No One's Around
An Interactive Fiction by Emily Seifert
Release 1 / Serial number 251008 / Inform 7 v10.1.2 / D

Bedroom (in the Bed)
The room where the human resides for most of her time during the school year. It's cozy. A galaxy themed aesthetic fills the bedsheets on the bed in which you and your fellow plushies lay on top of. The human is gone until 3pm, including her roommates. 

The way to leave the room is to the north. It's time to explore.

>use
That's not a verb I recognise.

>use laptop
That's not a verb I recognise.

* * *

What Rocky Does When No One's Around
An Interactive Fiction by Emily Seifert
Release 1 / Serial number 251008 / Inform 7 v10.1.2 / D

Bedroom (in the Bed)
The room where the human resides for most of her time during the school year. It's cozy. A galaxy themed aesthetic fills the bedsheets on the bed in which you and your fellow plushies lay on top of. The human is gone until 3pm, including her roommates. 

The way to leave the room is to the north. It's time to explore.

>use laptop
You need to be able use to reach the desk first. Maybe use the chair.

* * *

What Rocky Does When No One's Around
An Interactive Fiction by Emily Seifert
Release 1 / Serial number 251008 / Inform 7 v10.1.2 / D

Bedroom (in the Bed)
The room where the human resides for most of her time during the school year. It's cozy. A galaxy themed aesthetic fills the bedsheets on the bed in which you and your fellow plushies lay on top of. The human is gone until 3pm, including her roommates. 

The way to leave the room is to the north. It's time to explore.

>x laptop
It's a medium sized silver laptop with a lot of silly stickers plastered on top. It's amazing how many of these were able to survive being transferred between the old one and the current one.

>x bed
You are on the bed, there are other plushies on the pillows behind you.

In the Bed are Pillows and Rabbit.

>x pillow
You see nothing special about Pillow.

>x pillows
There are 4 pillows neatly stacked in front of each other. They could make for some good cushions if not for your friends on top.

On Pillows is Plushies.

>x plushies
There's a variety of little plush toys placed gently on each pillow.  They range from two tiny foxes, a white dog with a red target for an eye, and 4 bunnies of different shapes and sizes. The thin brown and grey rabbit sitting in front of the first pillow seems the most reasonable to talk to.

>take plushuies
You can't see any such thing.

>take plushies
Taken.

>x rabbit
It's the plushie sitting in front of the pillows, it looks reasonable to talk to.

>take pillows
Now that your friends are no longer on the pillows, you take them.

>talk to rabbit
"You appraoch the brown-grey rabbit instead. 
 Hi Rocky! What do you need?" the rabbit says.

 You politely ask the rabbit for him and the others plushies to leave the pillows so you can use them.

 "Oh! Okay! It would probably be a good change of scenery." it says as it convinces the others to leave. "Good luck with whatever you're doing! :)"

>l
Bedroom (in the Bed)
The room where the human resides for most of her time during the school year. 

The way to leave the room is to the north. It's time to explore.

On the Desk is Laptop.

In the Bed you can see Plushies and Rabbit.

>n
You would have to get out of the Bed first.

>get off bed
But you aren't on the Bed at the moment.

>get out of bed
You jump on the pile of pillows as they cushion your fall to the floor.

Bedroom
The room where the human resides for most of her time during the school year. 

The way to leave the room is to the north. It's time to explore.

On the Desk is Laptop.

>n
(first opening Bedroom door)
It seems to be locked.

>x desk
It's a bit messy, but yet organized. The laptop is the only thing that peaks your curiosity.

On the Desk is Laptop.

>x room
You can't see any such thing.

>x bedroom
You see nothing special about Bedroom door.

>i
You are carrying:
  Pillows

>unlock door
You place the pillow on the side of the door, and stand on top of it. You're able to reach the doorknob and open the door to the hallway.

* * *

>w
Path 1
Skull Kid's room is to the south.

>n
You can't go that way.

>s
Skull Kid's Room
 It's full of skull and meme memorabilia. Whatever a "meme" is you don't know.  There's a few of your stuffed friends on the bed in here.

You can see Dog Boy here.

>x dog boy
You see nothing special about Dog Boy.

>e
You can't go that way.

>w
You can't go that way.

>s
You can't go that way.

>n
Path 1
Skull Kid's room is to the south.

>n
You can't go that way.

>e
hallway
 You can go west to the area of Skull Kid's room or east to where the living room and Monster Kid's room are.

>go through
(Pillows)
That's not something you can enter.

>e
Path 2
Monster Kid's room is south. The living room is north of here.

* * *

>n
Living room
It's a wide open space that includes a couch and even at tv! For some reason, there is a ballpit here. The connected kitchen is west of here.

On Coffee table is Tv remote.

>x ballpit
It's a hexagonal pit next to the tv. It's full of colorful plastic balls. The pit even has a hoop! what fun!

>play in ballpit
You need to be inside the ballpit to play with it.

>enter ballpit
You get into Ballpit.

>use ballpit
You hop in the ballpit. It's full of multicolored balls. You have the uge to play inside.