What Rocky Does When No One's Around
An Interactive Fiction by Emily Seifert
Release 1 / Serial number 250930 / Inform 7 v10.1.2 / D

Bedroom (in the Bed)
The room where the human resides for most of her time during the school year. It's cozy. A galaxy themed aesthetic fills the bedsheets on the bed in which you and your fellow plushies lay on top of. The human is gone until 3pm, including her roommates. 

The way to leave the room is to the north. It's time to explore.

On the Desk is Laptop.

In the Bed you can see Pillows (on which is Plushies) and Rabbit.

I beg your pardon?

>sit chair
You hoist your body onto the seat and get on the chair. You reposition yourself so you're facing the desk.

Bedroom (on Chair)
The room where the human resides for most of her time during the school year. 

The way to leave the room is to the north. It's time to explore.

On the Desk is Laptop.

>use laptop
You open up the laptop and turn it on. It is just a bit slow like the human says it is, but it's still perfectly functional.
 You find yourself flumbing on here for hours.

 You don't know how it happened, but you end up watching an hour long deep dive video about a long gone childrens game. Time was lost to you.

* * *

What Rocky Does When No One's Around
An Interactive Fiction by Emily Seifert
Release 1 / Serial number 250930 / Inform 7 v10.1.2 / D

Bedroom (in the Bed)
The room where the human resides for most of her time during the school year. It's cozy. A galaxy themed aesthetic fills the bedsheets on the bed in which you and your fellow plushies lay on top of. The human is gone until 3pm, including her roommates. 

The way to leave the room is to the north. It's time to explore.

On the Desk is Laptop.

In the Bed you can see Pillows (on which is Plushies) and Rabbit.

>exit
(the Bed)
You may be made of fluff, but that would hurt!

>leave
You may be made of fluff, but that would hurt!

* * *

What Rocky Does When No One's Around
An Interactive Fiction by Emily Seifert
Release 1 / Serial number 250930 / Inform 7 v10.1.2 / D

Bedroom (in the Bed)
The room where the human resides for most of her time during the school year. It's cozy. A galaxy themed aesthetic fills the bedsheets on the bed in which you and your fellow plushies lay on top of. The human is gone until 3pm, including her roommates. 

The way to leave the room is to the north. It's time to explore.

On the Desk is Laptop.

In the Bed you can see Pillows (on which is Plushies) and Rabbit.

>hop
You jump on the spot.

>look
Bedroom (on the Bed)
The room where the human resides for most of her time during the school year. 

The way to leave the room is to the north. It's time to explore.

You can see Pillows here.

>look bed
You are on the bed, there are other plushies on the pillows behind you.

>look pillows
(Pillows)
You see nothing special about Pillows.

>look plushies
You can't see any such thing.

* * *

>hop
You jump on the spot.

>run
You'll have to say which compass direction to go in.

>s
You can't go that way.

>n
You can't go that way.

>w
You can't go that way.

>e
You can't go that way.

>ne
You can't go that way.

>sleep
You aren't feeling especially drowsy.

>sit
What do you want to sit on?

>sit ground
I didn't understand that sentence.

>sit on ground
You can't see any such thing.

>sit on floor
You can't see any such thing.

>look
Example Location

>sit on chait
You can't see any such thing.

* * *

What Rocky Does When No One's Around
An Interactive Fiction by Emily Seifert
Release 1 / Serial number 250930 / Inform 7 v10.1.2 / D

Bedroom (in the Bed)
The room where the human resides for most of her time during the school year. It's cozy. A galaxy themed aesthetic fills the bedsheets on the bed in which you and your fellow plushies lay on top of. The human is gone until 3pm, including her roommates. 

The way to leave the room is to the north. It's time to explore.

On the Desk is Laptop.

In the Bed you can see Pillows (on which is Plushies) and Rabbit.

>i
You are carrying nothing.

>talk rabbit
"You appraoch the brown-grey rabbit instead. 
 Hi Rocky! What do you need?" the rabbit says.

 You politely ask the rabbit for him and the others plushies to leave the pillows so you can use them.

 "Oh! Okay! It would probably be a good change of scenery." it says as it convinces the others to leave. "Good luck with whatever you're doing! :)"

>take pillows
Now that your friends are no longer on the pillows, you take them.

>i
You are carrying:
  Pillows

* * *

What Rocky Does When No One's Around
An Interactive Fiction by Emily Seifert
Release 1 / Serial number 250930 / Inform 7 v10.1.2 / D

Bedroom (in the Bed)
The room where the human resides for most of her time during the school year. It's cozy. A galaxy themed aesthetic fills the bedsheets on the bed in which you and your fellow plushies lay on top of. The human is gone until 3pm, including her roommates. 

The way to leave the room is to the north. It's time to explore.

On the Desk is Laptop.

In the Bed you can see Pillows (on which is Plushies) and Rabbit.

>leave
You get out of the Bed.

Bedroom
The room where the human resides for most of her time during the school year. 

The way to leave the room is to the north. It's time to explore.

On the Desk is Laptop.

>look desk
It's a bit messy, but yet organized. The laptop is the only thing that peaks your curiosity.

On the Desk is Laptop.

>look laptop
It's a medium sized silver laptop with a lot of silly stickers plastered on top. It's amazing how many of these were able to survive being transferred between the old one and the current one.

>use laptop
You need to be able use to reach the desk first. Maybe use the chair in front of the desk.

>look chair
It's a wooden chair with a cushioned seat and backing. You're just tall enough to climb on top.

>sit chair
You hoist your body onto the seat and get on the chair. You reposition yourself so you're facing the desk.

Bedroom (on Chair)
The room where the human resides for most of her time during the school year. 

The way to leave the room is to the north. It's time to explore.

On the Desk is Laptop.

* * *

What Rocky Does When No One's Around
An Interactive Fiction by Emily Seifert
Release 1 / Serial number 250930 / Inform 7 v10.1.2 / D

Bedroom (in the Bed)
The room where the human resides for most of her time during the school year. It's cozy. A galaxy themed aesthetic fills the bedsheets on the bed in which you and your fellow plushies lay on top of. The human is gone until 3pm, including her roommates. 

The way to leave the room is to the north. It's time to explore.

On the Desk is Laptop.

In the Bed you can see Pillows (on which is Plushies) and Rabbit.

>look
Bedroom
The room where the human resides for most of her time during the school year. 

The way to leave the room is to the north. It's time to explore.

>look bed
You are on the bed, there are other plushies on the pillows behind you.

>look desk
On the desk is Laptop.

* * *

>look bed
You are on the bed, there are other plushies on the pillows behind you.

>look pillows
You can't see any such thing.

* * *

>look
Bedroom
The room where the human resides for most of her time during the school year. 

The way to leave the room is to the north. It's time to explore.

>pillows
That's not a verb I recognise.

* * *

What Rocky Does When No One's Around
An Interactive Fiction by Emily Seifert
Release 1 / Serial number 250930 / Inform 7 v10.1.2 / D

Bedroom (in the Bed)
The room where the human resides for most of her time during the school year. It's cozy. A galaxy themed aesthetic fills the bedsheets on the bed in which you and your fellow plushies lay on top of. The human is gone until 3pm, including her roommates. 

The way to leave the room is to the north. It's time to explore.

On the Desk is Laptop.

In the Bed you can see Pillows (on which is Plushies) and Rabbit.

>look bed
You are on the bed, there are other plushies on the pillows behind you.

In the Bed is Pillows.

>look pillow
You can't see any such thing.

* * *

>look bed
You are on the bed, there are other plushies on the pillows behind you.

In the Bed is Pillows.

>look pillows
There are 4 pillows neatly stacked in front of each other. They could make for some good cushions if not for your friends on top.

On Pillows is Plushies.

>look plushies
There's a variety of little plush toys placed gently on each pillow.  They range from two tiny foxes, a white dog with a red target for an eye, and 4 bunnies of different shapes and sizes. The thin brown and grey rabbit sitting in front of the first pillow seems the most reasonable to talk to.

>talk to rabbit
"Hi Rocky! What do you need?" the rabbit says.
 You politely ask the rabbit and the others plushies to leave the pillows so you can use them.

 "Oh! Okay! Good luck with whatever you're doing! :)"

>take pillows
Now that your friends are no longer on the pillows, you take them.

>throw pillows
one by one you toss the pillows over the edge of the bed. They seemed to have made quite the pile to break your stuffed fall.

>n
You would have to get out of the Bed first.

>leave
You get out of the Bed.

Bedroom
The room where the human resides for most of her time during the school year. 

The way to leave the room is to the north. It's time to explore.

On the Desk is Laptop.

You can also see Pillows, Rabbit and Chair here.

* * *

>look pillows
There are 4 pillows neatly stacked in front of each other. They could make for some good cushions if not for your friends on top.

On Pillows is Plushies.

>take pillows
You don't want to move them when your plush friends are on top!

>look plushies
There's a variety of little plush toys placed gently on each pillow. They range from two tiny foxes, a white dog with a red target for an eye, and 4 bunnies of different shapes and sizes. The thin brown and grey rabbit sitting in front of the first pillow seems the most reasonable to talk to.

>look rabbit
It's the plushie sitting in front of the pillows, it looks reasonable to talk to.

>talk to rabbit
"Hi Rocky! What do you need?" the rabbit says.
 You politely ask the rabbit and the others plushies to leave the pillows so you can use them.

 "Oh! Okay! Good luck with whatever you're doing! :)"

* * *

>take pillows
Now that your friends are no longer on the pillows, you take them.

>throw pillows
(first taking Pillows)
Now that your friends are no longer on the pillows, you take them.

* * *

>look bed
You are on the bed, there are other plushies on the pillows behind you.

In the Bed is Pillows.

>take pillows
That's hardly portable.

* * *

What Rocky Does When No One's Around
An Interactive Fiction by Emily Seifert
Release 1 / Serial number 250930 / Inform 7 v10.1.2 / D

Bedroom (in the Bed)
The room where the human resides for most of her time during the school year. It's cozy. A galaxy themed aesthetic fills the bedsheets on the bed in which you and your fellow plushies lay on top of. The human is gone until 3pm, including her roommates. 

The way to leave the room is to the north. It's time to explore.

On the Desk is Laptop.

In the Bed you can see Pillows (on which is Plushies) and Rabbit.

>look ned
You can't see any such thing.

>look be
You can't see any such thing.

>look bed
You are on the bed, there are other plushies on the pillows behind you.

On the Bed is Pillows (on which is Plushies).

* * *

What Rocky Does When No One's Around
An Interactive Fiction by Emily Seifert
Release 1 / Serial number 250930 / Inform 7 v10.1.2 / D

Bedroom (in the Bed)
The room where the human resides for most of her time during the school year. It's cozy. A galaxy themed aesthetic fills the bedsheets on the bed in which you and your fellow plushies lay on top of. The human is gone until 3pm, including her roommates. 

The way to leave the room is to the north. It's time to explore.

On the Desk is Laptop.

In the Bed you can see Pillows (on which is Plushies) and Rabbit.

>look pillows
There are 4 pillows neatly stacked in front of each other. They could make for some good cushions if not for your friends on top.

On Pillows is Plushies.

>look bed
You are on the bed, there are other plushies on the pillows behind you.

* * *

>look pillows
There are 4 pillows neatly stacked in front of each other. They could make for some good cushions if not for your friends on top.

On Pillows is Plushies.

>look plushiws
You can't see any such thing.

>look plushies
There's a variety of little plush toys placed gently on each pillow. They range from two tiny foxes, a white dog with a red target for an eye, and 4 bunnies of different shapes and sizes. The thin brown and grey rabbit sitting in front of the first pillow seems the most reasonable to talk to.

* * *

>look rabbit
It's the plushie sitting in front of the pillows, it looks reasonable to talk to.

>talk rabbit
I didn't understand that sentence.

>talk to rabbit
"Hi Rocky! What do you need?" the rabbit says. You politely ask the rabbit and the others plushies to leave the pillows so you can use them. "Oh! Okay! Good luck with whatever you're doing! :)"

>take pillows
Now that your friends are no longer on the pillows, you take them.

* * *

What Rocky Does When No One's Around
An Interactive Fiction by Emily Seifert
Release 1 / Serial number 250930 / Inform 7 v10.1.2 / D

Bedroom (in the Bed)
The room where the human resides for most of her time during the school year. It's cozy. A galaxy themed aesthetic fills the bedsheets on the bed in which you and your fellow plushies lay on top of. The human is gone until 3pm, including her roommates. 

The way to leave the room is to the north. It's time to explore.

On the Desk is Laptop.

In the Bed you can see Pillows (on which is Plushies) and Rabbit.

>look pillowz
You can't see any such thing.

>look pillows
(Pillows)
There are 4 pillows neatly stacked in front of each other. They could make for some good cushions if not for your friends on top.

* * *

What Rocky Does When No One's Around
An Interactive Fiction by Emily Seifert
Release 1 / Serial number 250930 / Inform 7 v10.1.2 / D

Bedroom (in the Bed)
The room where the human resides for most of her time during the school year. It's cozy. A galaxy themed aesthetic fills the bedsheets on the bed in which you and your fellow plushies lay on top of. The human is gone until 3pm, including her roommates. 

The way to leave the room is to the north. It's time to explore.

On the Desk is Laptop.

In the Bed you can see Pillows (on which is Plushies) and Rabbit.

>look plushies
There's a variety of little plush toys placed gently on each pillow.  They range from two tiny foxes, a white dog with a red target for an eye, and 4 bunnies of different shapes and sizes. The thin brown and grey rabbit sitting in front of the first pillow seems the most reasonable to talk to.

>talk rabbit
I didn't understand that sentence.

>look rabbi
You can't see any such thing.

>look rabbit
It's the plushie sitting in front of the pillows, it looks reasonable to talk to.

* * *

What Rocky Does When No One's Around
An Interactive Fiction by Emily Seifert
Release 1 / Serial number 250930 / Inform 7 v10.1.2 / D

Bedroom (in the Bed)
The room where the human resides for most of her time during the school year. It's cozy. A galaxy themed aesthetic fills the bedsheets on the bed in which you and your fellow plushies lay on top of. The human is gone until 3pm, including her roommates. 

The way to leave the room is to the north. It's time to explore.

On the Desk is Laptop.

In the Bed you can see Pillows (on which is Plushies) and Rabbit.

>n
You would have to get out of the Bed first.

>e
Path 2
This is where Monster Kid's room is.

>e
You can't go that way.

>n
Living room
It's a wide open space that includes a couch and even at tv! For some reason, there is a ballpit here.

>n
Entrance

* * *

>n
Living room
It's a wide open space that includes a couch and even at tv! For some reason, there is a ballpit here.

>w
Kitchen
It's connected to the living room. The sink has apparently been leaking since you moved in. You wonder what it would be like to try to make some food.

>e
Living room
It's a wide open space that includes a couch and even at tv! For some reason, there is a ballpit here.

* * *

>e
Path 2
This is where Monster Kid's room is.

>s
Monster Kid's Room
It's pretty bare bones. There's a few scary looking monster figures on the dresser and the windowsill, fake plants are scattered around as well. You don't know why you walked in here...

>n
Path 2
This is where Monster Kid's room is.

>w
Hallway
Yup, its a hallway. There's a beam in the middle of the space. Someone could run into that!

>w
Path 1
This is where Skull Kid's room is.

>n
You can't go that way.

>s
Skull Kid's Room
It's full of skull and meme memorabilia. Whatever a "meme" is you don't know. There's a few of your stuffed friends in here.

>n
Path 1
This is where Skull Kid's room is.

* * *

>n
You would have to get out of the Bed first.

>leave
You may be made of fluff, but that would hurt!

>jump
You jump on the spot.

>jump off bed
You may be made of fluff, but that would hurt!

>look bed
You are on the bed, there are other plushies on the pillows behind you.

In the Bed are Pillows and Rabbit.

>look pillows
There are 4 pillows neatly stacked in front of each other. They could make for some good cushions if not for your friends on top.

On Pillows is Plushies.

* * *

>look plushies
There's a variety of little plush toys placed gently on each pillow.  They range from two tiny foxes, a white dog with a red target for an eye, and 4 bunnies of different shapes and sizes. The thin brown and grey rabbit sitting in front of the first pillow seems the most reasonable to talk to.

>talk plushies
As you attempt to ask the plushies to move, the white branded dog on top of the hoard interjects 
 "Hey!" he says, "We aren't gonna move just because you asked us!!"

 "Yeah! The foxes and smaller rabbits say, "We only follow what eachother here on the pillows say! 

 It looks as if you might need to find a more reasonable plushie.

>look rabbit
It's the plushie sitting in front of the pillows, it looks reasonable to talk to.

>talk rabbit
"You appraoch the brown-grey rabbit instead. 
 Hi Rocky! What do you need?" the rabbit says.

 You politely ask the rabbit for him and the others plushies to leave the pillows so you can use them.

 "Oh! Okay! It would probably be a good change of scenery." it says as it convinces the others to leave. "Good luck with whatever you're doing! :)"

* * *

>throw pillows
one by one you toss the pillows over the edge of the bed. They seemed to have made quite the pile to break your stuffed fall.

>jump off bef
I only understood you as far as wanting to jump.

>jump off bed
You jump on the pile of pillows as they cushion your fall to the floor.

Bedroom
The room where the human resides for most of her time during the school year. 

The way to leave the room is to the north. It's time to explore.

On the Desk is Laptop.

You can also see Pillows here.

>desk
That's not a verb I recognise.

>look desk
It's a bit messy, but yet organized. The laptop is the only thing that peaks your curiosity.

On the Desk is Laptop.

>look chair
It's a wooden chair with a cushioned seat and backing. You're just tall enough to climb on top.

>sit chair
You hoist your body onto the seat and get on the chair. You reposition yourself so you're facing the desk.

Bedroom (on Chair)
The room where the human resides for most of her time during the school year. 

The way to leave the room is to the north. It's time to explore.

On the Desk is Laptop.

You can also see Pillows here.

>use laptop
You open up the laptop and turn it on. It is just a bit slow like the human says it is, but it's still perfectly functional.
 You find yourself flumbing on here for hours.

 You don't know how it happened, but you end up watching an hour long deep dive video about a long gone childrens game. Time was lost to you.

* * *

>n
You would have to get out of the Bed first.

>s
Bedroom
The room where the human resides for most of her time during the school year. 

The way to leave the room is to the north. It's time to explore.

On the Bed is Pillows (on which is Plushies).

On the Desk is Laptop.

You can also see Rabbit here.

>n
Hallway
 You can go west to the area of Skull Kid's room or east to where the living room and Monster Kid's room are.

* * *

>s
Bedroom
The room where the human resides for most of her time during the school year. 

The way to leave the room is to the north. It's time to explore.

On the Bed is Pillows (on which is Plushies).

On the Desk is Laptop.

You can also see Rabbit here.

>s
You can't go that way.

>bed
That's not a verb I recognise.

>look bed
You are on the bed, there are other plushies on the pillows behind you.

On the Bed is Pillows (on which is Plushies).

>look pillows
There are 4 pillows neatly stacked in front of each other. They could make for some good cushions if not for your friends on top.

On Pillows is Plushies.

* * *

>n
You would have to get out of the Bed first.

>w
Path 1
Skull Kid's room is to the south.

>s
Skull Kid's Room
 It's full of skull and meme memorabilia. Whatever a "meme" is you don't know.  There's a few of your stuffed friends on the bed in here.

You can see Dog Boy here.

>look bed
 The bedding is black with white skulls, and has red sheets underneath. Of all the plushies that reside on top when Skull Kid is gone, Dog Boy, the rotund golden retreiver, is the one you talk to the most.

* * *

What Rocky Does When No One's Around
An Interactive Fiction by Emily Seifert
Release 1 / Serial number 250930 / Inform 7 v10.1.2 / D

Bedroom (in the Bed)
The room where the human resides for most of her time during the school year. It's cozy. A galaxy themed aesthetic fills the bedsheets on the bed in which you and your fellow plushies lay on top of. The human is gone until 3pm, including her roommates. 

The way to leave the room is to the north. It's time to explore.

On the Desk is Laptop.

In the Bed you can see Pillows (on which is Plushies) and Rabbit.

>take laptop
You can't reach Laptop from here.

* * *

What Rocky Does When No One's Around
An Interactive Fiction by Emily Seifert
Release 1 / Serial number 250930 / Inform 7 v10.1.2 / D

Bedroom (in the Bed)
The room where the human resides for most of her time during the school year. It's cozy. A galaxy themed aesthetic fills the bedsheets on the bed in which you and your fellow plushies lay on top of. The human is gone until 3pm, including her roommates. 

The way to leave the room is to the north. It's time to explore.

On the Desk is Laptop.

In the Bed you can see Pillows (on which is Plushies) and Rabbit.

>take pillow
(Pillows)
You don't want to move them when your plush friends are on top!

>talk rabbit
"You appraoch the brown-grey rabbit instead. 
 Hi Rocky! What do you need?" the rabbit says.

 You politely ask the rabbit for him and the others plushies to leave the pillows so you can use them.

 "Oh! Okay! It would probably be a good change of scenery." it says as it convinces the others to leave. "Good luck with whatever you're doing! :)"

* * *

>throw pillows
one by one you toss the pillows over the edge of the bed. They seemed to have made quite the pile to break your stuffed fall.

>jump off bed
You jump on the pile of pillows as they cushion your fall to the floor.

Bedroom
The room where the human resides for most of her time during the school year. 

The way to leave the room is to the north. It's time to explore.

On the Desk is Laptop.

You can also see Pillows here.

>take pillows
you take them.

>take pillow
(Pillows)
you take them.

* * *

What Rocky Does When No One's Around
An Interactive Fiction by Emily Seifert
Release 1 / Serial number 250930 / Inform 7 v10.1.2 / D

Bedroom (in the Bed)
The room where the human resides for most of her time during the school year. It's cozy. A galaxy themed aesthetic fills the bedsheets on the bed in which you and your fellow plushies lay on top of. The human is gone until 3pm, including her roommates. 

The way to leave the room is to the north. It's time to explore.

On the Desk is Laptop.

In the Bed you can see Pillows (on which is Plushies) and Rabbit.

>take pillows
(Now the pillows)
You can't reach Now the pillows from here.

>hop
You jump on the spot.

* * *

>take pillows
(Now the pillows)
You can't reach Now the pillows from here.

>look bed
You are on the bed, there are other plushies on the pillows behind you.

In the Bed is Pillows.

>look pillows
(Now pillows)
You see nothing special about Now pillows.

* * *

What Rocky Does When No One's Around
An Interactive Fiction by Emily Seifert
Release 1 / Serial number 250930 / Inform 7 v10.1.2 / D

Bedroom (in the Bed)
The room where the human resides for most of her time during the school year. It's cozy. A galaxy themed aesthetic fills the bedsheets on the bed in which you and your fellow plushies lay on top of. The human is gone until 3pm, including her roommates. 

The way to leave the room is to the north. It's time to explore.

On the Desk is Laptop.

In the Bed you can see Pillows (on which is Plushies) and Rabbit.

>talk plushies
As you attempt to ask the plushies to move, the white branded dog on top of the hoard interjects 
 "Hey!" he says, "We aren't gonna move just because you asked us!!"

 "Yeah! The foxes and smaller rabbits say, "We only follow what each other here on the pillows say! 

 It looks as if you might need to find a more reasonable plushie.

>leave
You get out of the Bed.

Bedroom
The room where the human resides for most of her time during the school year. 

The way to leave the room is to the north. It's time to explore.

On the Desk is Laptop.

You can also see Rabbit here.

>desk
That's not a verb I recognise.

* * *

>look desk
It's a bit messy, but yet organized. The laptop is the only thing that peaks your curiosity.

On the Desk is Laptop.

>look laptop
You see nothing special about Laptop.

* * *

>talk plushies
As you attempt to ask the plushies to move, the white branded dog on top of the hoard interjects 
 "Hey!" he says, "We aren't gonna move just because you asked us!!"

 "Yeah! The foxes and smaller rabbits say, "We only follow what each other here on the pillows say! 

 It looks as if you might need to find a more reasonable plushie.

>talk rabbit
"You appraoch the brown-grey rabbit instead. 
 Hi Rocky! What do you need?" the rabbit says.

 You politely ask the rabbit for him and the others plushies to leave the pillows so you can use them.

 "Oh! Okay! It would probably be a good change of scenery." it says as it convinces the others to leave. "Good luck with whatever you're doing! :)"

* * *

>take pillows
Now that your friends are no longer on the pillows, you take them.

>drop
(Pillows)
Dropped.

>take pillows
you take them.

>throw pillows
one by one you toss the pillows over the edge of the bed. They seemed to have made quite the pile to break your stuffed fall.

>leave
You jump on the pile of pillows as they cushion your fall to the floor.

Bedroom
The room where the human resides for most of her time during the school year. 

The way to leave the room is to the north. It's time to explore.

On the Desk is Laptop.

You can also see Pillows here.

>take pillow
You can't see any such thing.

>take pillows
you take them.

* * *

>take pillows
Now that your friends are no longer on the pillows, you take them.

>drop pillows
Dropped.

>take pillows
Now that your friends are no longer on the pillows, you take them.

* * *

>talk plushies
As you attempt to ask the plushies to move, the white branded dog on top of the hoard interjects 
 "Hey!" he says, "We aren't gonna move just because you asked us!!"

 "Yeah! The foxes and smaller rabbits say, "We only follow what each other here on the pillows say! 

 It looks as if you might need to find a more reasonable plushie.

>talk to plushies
As you attempt to ask the plushies to move, the white branded dog on top of the hoard interjects 
 "Hey!" he says, "We aren't gonna move just because you asked us!!"

 "Yeah! The foxes and smaller rabbits say, "We only follow what eachother here on the pillows say! 

 It looks as if you might need to find a more reasonable plushie.

>talk to rabbit
"Hi Rocky! What do you need?" the rabbit says.
 You politely ask the rabbit and the others plushies to leave the pillows so you can use them.

 "Oh! Okay! Good luck with whatever you're doing! :)"

* * *

What Rocky Does When No One's Around
An Interactive Fiction by Emily Seifert
Release 1 / Serial number 250930 / Inform 7 v10.1.2 / D

Bedroom (in the Bed)
The room where the human resides for most of her time during the school year. It's cozy. A galaxy themed aesthetic fills the bedsheets on the bed in which you and your fellow plushies lay on top of. The human is gone until 3pm, including her roommates. 

The way to leave the room is to the north. It's time to explore.

On the Desk is Laptop.

In the Bed you can see Pillows (on which is Plushies) and Rabbit.

>talk rabbit
"You appraoch the brown-grey rabbit instead. 
 Hi Rocky! What do you need?" the rabbit says.

 You politely ask the rabbit for him and the others plushies to leave the pillows so you can use them.

 "Oh! Okay! It would probably be a good change of scenery." it says as it convinces the others to leave. "Good luck with whatever you're doing! :)"

>look plushies
There's a variety of little plush toys placed gently on each pillow. They range from two tiny foxes, a white dog with a red target for an eye, and 4 bunnies of different shapes and sizes. The thin brown and grey rabbit sitting in front of the first pillow seems the most reasonable to talk to.

>talk to rabbit
"Hi Rocky! What do you need?" the rabbit says.
 You politely ask the rabbit and the others plushies to leave the pillows so you can use them.

 "Oh! Okay! Good luck with whatever you're doing! :)"

* * *

>talk rabbit
"You appraoch the brown-grey rabbit instead. 
 Hi Rocky! What do you need?" the rabbit says.

 You politely ask the rabbit for him and the others plushies to leave the pillows so you can use them.

 "Oh! Okay! It would probably be a good change of scenery." it says as it convinces the others to leave. "Good luck with whatever you're doing! :)"

>take pillow
Now that your friends are no longer on the pillows, you take them.

>throw pillow
one by one you toss the pillows over the edge of the bed. They seemed to have made quite the pile to break your stuffed fall.

>leave
You jump on the pile of pillows as they cushion your fall to the floor.

Bedroom
The room where the human resides for most of her time during the school year. 

The way to leave the room is to the north. It's time to explore.

On the Desk is Laptop.

You can also see Pillows here.

>open door
You're just too short to reach the doorknob. Maybe there's something you can stand on.

>n
(first opening Bedroom door)
You're just too short to reach the doorknob. Maybe there's something you can stand on.

>n
(first opening Bedroom door)
You're just too short to reach the doorknob. Maybe there's something you can stand on.

>take pillow
you take them.

>open door
You're just too short to reach the doorknob. Maybe there's something you can stand on.

>use pillow on door
I only understood you as far as wanting to use Pillows.

* * *

>take pillows
Now that your friends are no longer on the pillows, you take them.

>throw
(Pillows)
one by one you toss the pillows over the edge of the bed. They seemed to have made quite the pile to break your stuffed fall.

>leave
You jump on the pile of pillows as they cushion your fall to the floor.

Bedroom
The room where the human resides for most of her time during the school year. 

The way to leave the room is to the north. It's time to explore.

On the Desk is Laptop.

You can also see Pillows here.

>take pillow
(Pillows)
you take them.

>open door
It seems to be locked.

>unlock door
You place the pillow on the side of the door, and stand on top of it. You're able to reach the doorknob and open the door to the hallway.

>n
(first opening Bedroom door)

hallway
 Yup, its a hallway. There's a beam in the middle of the space. Someone could run into that!  You can go west to the area of Skull Kid's room or east to where the living room and Monster Kid's room are.

* * *

>take pillow
(Pillows)
you take them.

>take pillows
you take them.

* * *

>leave
You jump on the pile of pillows as they cushion your fall to the floor.

Bedroom
The room where the human resides for most of her time during the school year. 

The way to leave the room is to the north. It's time to explore.

On the Desk is Laptop.

You can also see Pillows here.

>take pillows
you take them.

>open door
You place the pillow on the side of the door, and stand on top of it. You're able to reach the doorknob and open the door to the hallway.

>n
(first opening Bedroom door)
You place the pillow on the side of the door, and stand on top of it. You're able to reach the doorknob and open the door to the hallway.

>n
(first opening Bedroom door)
You place the pillow on the side of the door, and stand on top of it. You're able to reach the doorknob and open the door to the hallway.

>leave
You jump on the pile of pillows as they cushion your fall to the floor.

Bedroom
The room where the human resides for most of her time during the school year. 

The way to leave the room is to the north. It's time to explore.

On the Desk is Laptop.

* * *

>open door
You place the pillow on the side of the door, and stand on top of it. You're able to reach the doorknob and open the door to the hallway.

* * *

>n
(first opening Bedroom door)
You place the pillow on the side of the door, and stand on top of it. You're able to reach the doorknob and open the door to the hallway.

I beg your pardon?

* * *

>take pillow
(Pillows)
you take them.

>open door
You're just too short to reach the doorknob. Maybe there's something you can stand on.

>use pillows on door
I only understood you as far as wanting to use Pillows.

>use pillow
(Pillows)

>door
That's not a verb I recognise.

* * *

>throw pillows
one by one you toss the pillows over the edge of the bed. They seemed to have made quite the pile to break your stuffed fall.

>leave bed
You jump on the pile of pillows as they cushion your fall to the floor.

Bedroom
The room where the human resides for most of her time during the school year. 

The way to leave the room is to the north. It's time to explore.

On the Desk is Laptop.

You can also see Pillows here.

>take pilows
You can't see any such thing.

>take pillows
you take them.

>n
(first opening Bedroom door)
It seems to be locked.

>use pillow
You can't see any such thing.

>use pillow
You can't see any such thing.

* * *

>use pillows on door
I only understood you as far as wanting to use Pillows.

* * *

>talk rabbit
"You appraoch the brown-grey rabbit instead. 
 Hi Rocky! What do you need?" the rabbit says.

 You politely ask the rabbit for him and the others plushies to leave the pillows so you can use them.

 "Oh! Okay! It would probably be a good change of scenery." it says as it convinces the others to leave. "Good luck with whatever you're doing! :)"

>talk to rabbit
"You appraoch the brown-grey rabbit instead. 
 Hi Rocky! What do you need?" the rabbit says.
 You politely ask the rabbit for him and the others plushies to leave the pillows so you can use them.

 "Oh! Okay! It would probably be a good change of scenery" it says as it convinces the others to leave. "Good luck with whatever you're doing! :)"

* * *

What Rocky Does When No One's Around
An Interactive Fiction by Emily Seifert
Release 1 / Serial number 250930 / Inform 7 v10.1.2 / D

Bedroom (in the Bed)
The room where the human resides for most of her time during the school year. It's cozy. A galaxy themed aesthetic fills the bedsheets on the bed in which you and your fellow plushies lay on top of. The human is gone until 3pm, including her roommates. 

The way to leave the room is to the north. It's time to explore.

On the Desk is Laptop.

In the Bed you can see Pillows (on which is Plushies) and Rabbit.

>talk to rabbit
"You appraoch the brown-grey rabbit instead. 
 Hi Rocky! What do you need?" the rabbit says.

 You politely ask the rabbit for him and the others plushies to leave the pillows so you can use them.

 "Oh! Okay! It would probably be a good change of scenery" it says as it convinces the others to leave. "Good luck with whatever you're doing! :)"

* * *

What Rocky Does When No One's Around
An Interactive Fiction by Emily Seifert
Release 1 / Serial number 250930 / Inform 7 v10.1.2 / D

Bedroom (in the Bed)
The room where the human resides for most of her time during the school year. It's cozy. A galaxy themed aesthetic fills the bedsheets on the bed in which you and your fellow plushies lay on top of. The human is gone until 3pm, including her roommates. 

The way to leave the room is to the north. It's time to explore.

On the Desk is Laptop.

In the Bed you can see Pillows (on which is Plushies) and Rabbit.

>use
That's not a verb I recognise.

>use laptop
That's not a verb I recognise.

* * *

What Rocky Does When No One's Around
An Interactive Fiction by Emily Seifert
Release 1 / Serial number 250930 / Inform 7 v10.1.2 / D

Bedroom (in the Bed)
The room where the human resides for most of her time during the school year. It's cozy. A galaxy themed aesthetic fills the bedsheets on the bed in which you and your fellow plushies lay on top of. The human is gone until 3pm, including her roommates. 

The way to leave the room is to the north. It's time to explore.

On the Desk is Laptop.

In the Bed you can see Pillows (on which is Plushies) and Rabbit.

>use laptop
You need to be able use to reach the desk first. Maybe use the chair.